ts,idservel,c1,c2,c3,c4,c5,c6,c7,vv,vn,vb,vt,me,tm,cm,w1V
2021-11-26 16:43:19.306967,2564,1978,2877,817,1352,90,472,568,8154,43,20,8217,43,43,100.0,Kast
2021-11-26 16:43:19.306967,2801,636,467,520,320,31,151,359,2484,19,16,2519,21,21,100.0,Boric
2021-11-26 16:43:19.306967,2674,377,502,399,155,40,119,255,1847,81,80,2008,19,19,100.0,Kast
2021-11-26 16:43:19.306967,2523,260,265,891,87,11,56,365,1935,15,14,1964,18,18,100.0,Provoste
2021-11-26 16:43:19.306967,2502,3183,5860,2212,1212,263,1712,9884,24326,173,70,24569,179,179,100.0,Parisi
2021-11-26 16:43:19.306967,2717,3793,4372,2350,1827,230,938,2120,15630,123,131,15884,120,120,100.0,Kast
2021-11-26 16:43:19.306967,2528,1181,661,797,307,64,408,1172,4590,61,49,4700,35,35,100.0,Boric
2021-11-26 16:43:19.306967,2696,2805,9972,2197,2021,153,940,3070,21158,177,110,21445,140,140,100.0,Kast
2021-11-26 16:43:19.306967,2752,4,34,1,2,0,2,4,47,0,0,47,1,1,100.0,Kast
2021-11-26 16:43:19.306967,2508,28116,27242,10136,9973,1632,8858,36254,122211,959,383,123553,854,854,100.0,Parisi
2021-11-26 16:43:19.306967,2662,245,547,332,210,17,91,400,1842,27,11,1880,15,15,100.0,Kast
2021-11-26 16:43:19.306967,2655,2203,4983,1687,1138,123,862,3366,14362,143,100,14605,118,118,100.0,Kast
2021-11-26 16:43:19.306967,2822,14763,24070,7921,6020,952,4536,23033,81295,712,295,82302,559,559,100.0,Kast
2021-11-26 16:43:19.306967,2739,2188,2314,1396,716,126,551,1664,8955,122,86,9163,70,70,100.0,Kast
2021-11-26 16:43:19.306967,2797,10500,11636,3809,4609,513,3189,5237,39493,481,132,40106,253,253,100.0,Kast
2021-11-26 16:43:19.306967,2827,1265,3045,1456,1273,79,458,965,8541,133,76,8750,67,67,100.0,Kast
2021-11-26 16:43:19.306967,2554,2322,1427,1258,663,101,680,1308,7759,76,42,7877,53,53,100.0,Boric
2021-11-26 16:43:19.306967,2751,189,421,74,63,10,28,82,867,6,5,878,6,6,100.0,Kast
2021-11-26 16:43:19.306967,2663,1309,3698,1279,942,88,677,2771,10764,93,98,10955,74,74,100.0,Kast
2021-11-26 16:43:19.306967,2512,8984,11688,4912,3589,595,3910,23638,57316,522,189,58027,393,393,100.0,Parisi
2021-11-26 16:43:19.306967,2708,2162,3387,1432,1099,154,710,2208,11152,141,166,11459,97,97,100.0,Kast
2021-11-26 16:43:19.306967,2518,1516,1263,1680,440,105,458,1741,7203,50,38,7291,45,45,100.0,Parisi
2021-11-26 16:43:19.306967,2559,5607,4012,2027,2066,276,2442,4967,21397,201,75,21673,132,132,100.0,Boric
2021-11-26 16:43:19.306967,2798,2586,3596,1067,1693,115,693,754,10504,59,40,10603,67,67,100.0,Kast
2021-11-26 16:43:19.306967,2550,1304,1365,942,736,91,620,1243,6301,98,40,6439,34,34,100.0,Kast
2021-11-26 16:43:19.306967,2823,111,252,195,57,6,53,375,1049,14,4,1067,11,11,100.0,Parisi
2021-11-26 16:43:19.306967,2504,60,384,47,31,3,16,328,869,7,7,883,8,8,100.0,Kast
2021-11-26 16:43:19.306967,2533,1161,663,851,294,46,134,679,3828,39,36,3903,30,30,100.0,Boric
2021-11-26 16:43:19.306967,2656,1742,6296,1457,894,157,571,1361,12478,122,101,12701,87,87,100.0,Kast
2021-11-26 16:43:19.306967,2676,1226,3976,1748,955,113,497,944,9459,90,84,9633,78,78,100.0,Kast
2021-11-26 16:43:19.306967,2565,2188,2321,1173,971,158,1040,877,8728,68,37,8833,55,55,100.0,Kast
2021-11-26 16:43:19.306967,2542,2850,3330,1254,1386,151,768,1081,10820,106,44,10970,67,67,100.0,Kast
2021-11-26 16:43:19.306967,2716,4868,4448,2414,1868,320,954,2733,17605,149,123,17877,135,135,100.0,Boric
2021-11-26 16:43:19.306967,2570,1220,990,663,591,47,483,1142,5136,62,39,5237,36,36,100.0,Boric
2021-11-26 16:43:19.306967,2622,1999,7100,1967,2379,113,762,1311,15631,182,127,15940,120,120,100.0,Kast
2021-11-26 16:43:19.306967,2759,9637,7190,2971,3812,593,3536,2994,30733,221,88,31042,205,205,100.0,Boric
2021-11-26 16:43:19.306967,2760,15350,8802,5813,4615,1435,7016,5398,48429,360,222,49011,350,350,100.0,Boric
2021-11-26 16:43:19.306967,2733,291,555,304,149,11,69,126,1505,13,32,1550,17,17,100.0,Kast
2021-11-26 16:43:19.306967,2623,462,1719,583,391,16,140,235,3546,63,45,3654,34,34,100.0,Kast
2021-11-26 16:43:19.306967,2520,1053,702,1273,278,51,263,1249,4869,45,20,4934,38,38,100.0,Provoste
2021-11-26 16:43:19.306967,2603,925,1559,841,853,34,338,586,5136,34,25,5195,41,41,100.0,Kast
2021-11-26 16:43:19.306967,2644,8106,9097,3892,4075,491,2737,5927,34325,228,100,34653,200,200,100.0,Kast
2021-11-26 16:43:19.306967,2745,601,488,332,173,26,86,184,1890,29,22,1941,20,20,100.0,Boric
2021-11-26 16:43:19.306967,2826,14744,24290,9009,9421,703,3914,9349,71430,657,245,72332,453,453,100.0,Kast
2021-11-26 16:43:19.306967,2828,1894,3694,1546,1308,101,822,1729,11094,97,39,11230,68,68,100.0,Kast
2021-11-26 16:43:19.306967,2604,2540,3464,1980,1797,122,980,2337,13220,143,119,13482,90,90,100.0,Kast
2021-11-26 16:43:19.306967,2695,789,1820,780,549,86,355,822,5201,129,66,5396,33,33,100.0,Kast
2021-11-26 16:43:19.306967,2718,1209,1194,975,498,96,280,1001,5253,47,46,5346,40,40,100.0,Boric
2021-11-26 16:43:19.306967,2740,409,764,283,210,23,118,264,2071,17,27,2115,18,18,100.0,Kast
2021-11-26 16:43:19.306967,2836,460,805,450,414,23,124,266,2542,35,29,2606,19,19,100.0,Kast
2021-11-26 16:43:19.306967,2709,284,646,181,197,19,69,148,1544,13,32,1589,16,16,100.0,Kast
2021-11-26 16:43:19.306967,2742,357,428,264,176,12,49,101,1387,24,29,1440,13,13,100.0,Kast
2021-11-26 16:43:19.306967,2580,1327,1175,642,578,58,522,1008,5310,64,35,5409,35,35,100.0,Boric
2021-11-26 16:43:19.306967,2837,1077,2711,1417,784,50,405,1142,7586,69,84,7739,57,57,100.0,Kast
2021-11-26 16:43:19.306967,2843,1024,4445,1330,1220,91,460,997,9567,89,89,9745,73,73,100.0,Kast
2021-11-26 16:43:19.306967,2581,769,946,344,475,24,291,422,3271,37,23,3331,22,22,100.0,Kast
2021-11-26 16:43:19.306967,2635,1512,2140,1198,834,76,674,1132,7566,94,79,7739,55,55,100.0,Kast
2021-11-26 16:43:19.306967,2505,17,419,18,10,4,5,433,906,8,1,915,14,14,100.0,Parisi
2021-11-26 16:43:19.306967,2793,7968,18095,3522,9621,385,3011,3987,46589,293,169,47051,278,278,100.0,Kast
2021-11-26 16:43:19.306967,2697,1119,4949,923,676,89,486,1170,9412,105,107,9624,67,67,100.0,Kast
2021-11-26 16:43:19.306967,2582,1526,1880,974,943,74,582,1139,7118,59,39,7216,48,48,100.0,Kast
2021-11-26 16:43:19.306967,2537,1212,885,1270,377,67,211,937,4959,56,58,5073,39,39,100.0,Provoste
2021-11-26 16:43:19.306967,2642,24338,30006,11017,12724,1428,5749,12689,97951,665,315,98931,637,637,100.0,Kast
2021-11-26 16:43:19.306967,2761,17619,10987,5973,6007,1156,6538,4786,53066,410,194,53670,387,387,100.0,Boric
2021-11-26 16:43:19.306967,2543,5100,9357,2029,4702,227,1251,2128,24794,138,76,25008,119,119,100.0,Kast
2021-11-26 16:43:19.306967,2613,2927,4469,2754,2062,188,1188,3860,17448,181,122,17751,122,122,100.0,Kast
2021-11-26 16:43:19.306967,2657,330,1557,306,138,26,139,215,2711,23,21,2755,23,23,100.0,Kast
2021-11-26 16:43:19.306967,2517,11766,11840,10378,4342,786,3226,13555,55893,376,160,56429,417,417,100.0,Parisi
2021-11-26 16:43:19.306967,2527,18946,15848,7919,7474,1052,5792,14955,71986,561,313,72860,502,502,100.0,Boric
2021-11-26 16:43:19.306967,2643,8256,11599,4787,2766,496,3196,10234,41334,431,173,41938,339,339,100.0,Kast
2021-11-26 16:43:19.306967,2811,578,556,519,148,22,134,310,2267,19,24,2310,18,18,100.0,Boric
2021-11-26 16:43:19.306967,2737,5787,6756,3845,2350,284,1090,2692,22804,210,124,23138,167,167,100.0,Kast
2021-11-26 16:43:19.306967,2677,1091,3389,1167,779,57,413,961,7857,77,53,7987,62,62,100.0,Kast
2021-11-26 16:43:19.306967,2698,996,4160,840,605,59,353,657,7670,82,62,7814,63,63,100.0,Kast
2021-11-26 16:43:19.306967,2802,3875,3664,1661,1831,168,1002,1238,13439,96,75,13610,79,79,100.0,Boric
2021-11-26 16:43:19.306967,2719,255,301,291,114,10,57,206,1234,11,16,1261,12,12,100.0,Kast
2021-11-26 16:43:19.306967,2658,2127,3898,1962,801,157,789,2550,12284,150,128,12562,93,93,100.0,Kast
2021-11-26 16:43:19.306967,2678,548,1231,333,341,51,125,270,2899,23,21,2943,25,25,100.0,Kast
2021-11-26 16:43:19.306967,2614,887,1062,842,630,35,191,385,4032,56,41,4129,36,36,100.0,Kast
2021-11-26 16:43:19.306967,2625,12531,17171,6936,7992,642,4656,7855,57783,450,253,58486,383,383,100.0,Kast
2021-11-26 16:43:19.306967,2720,919,1086,709,488,67,259,796,4324,45,38,4407,38,38,100.0,Kast
2021-11-26 16:43:19.306967,2521,1085,561,987,192,73,244,1486,4628,46,20,4694,45,45,100.0,Parisi
2021-11-26 16:43:19.306967,2583,2293,1975,1009,1085,93,760,1440,8655,69,46,8770,59,59,100.0,Boric
2021-11-26 16:43:19.306967,2762,18777,13457,7127,6539,1207,7734,6186,61027,483,209,61719,434,434,100.0,Boric
2021-11-26 16:43:19.306967,2829,567,2331,926,649,25,209,395,5102,29,37,5168,39,39,100.0,Kast
2021-11-26 16:43:19.306967,2806,3596,3130,1764,1458,204,1289,1890,13331,149,83,13563,83,83,100.0,Boric
2021-11-26 16:43:19.306967,2566,2406,2027,815,1022,123,663,707,7763,44,19,7826,43,43,100.0,Boric
2021-11-26 16:43:19.306967,2567,2224,1791,840,799,141,759,535,7089,38,18,7145,37,37,100.0,Boric
2021-11-26 16:43:19.306967,2615,123,855,235,194,6,94,300,1807,17,11,1835,15,15,100.0,Kast
2021-11-26 16:43:19.306967,2699,485,1490,322,211,50,182,179,2919,33,20,2972,28,28,100.0,Kast
2021-11-26 16:43:19.306967,2763,18230,12049,5736,6345,1163,5491,3632,52646,591,194,53431,399,399,100.0,Boric
2021-11-26 16:43:19.306967,2645,623,1562,804,606,55,317,675,4642,59,38,4739,34,34,100.0,Kast
2021-11-26 16:43:19.306967,2679,1381,3631,1630,911,126,571,950,9200,120,90,9410,77,77,100.0,Kast
2021-11-26 16:43:19.306967,2524,425,305,1168,135,22,69,512,2636,17,12,2665,18,18,100.0,Provoste
2021-11-26 16:43:19.306967,2710,839,2052,1178,458,44,211,491,5273,63,69,5405,42,42,100.0,Kast
2021-11-26 16:43:19.306967,2711,1351,3260,1329,786,60,375,1208,8369,54,63,8486,51,51,100.0,Kast
2021-11-26 16:43:19.306967,2734,208,435,155,150,15,34,60,1057,8,14,1079,12,12,100.0,Kast
2021-11-26 16:43:19.306967,2819,1008,2803,890,692,74,244,806,6517,67,42,6626,46,46,100.0,Kast
2021-11-26 16:43:19.306967,2680,880,1802,1134,364,73,376,473,5102,68,59,5229,37,37,100.0,Kast
2021-11-26 16:43:19.306967,2825,24,140,39,26,5,26,239,499,7,7,513,6,6,100.0,Parisi
2021-11-26 16:43:19.306967,2681,794,3155,841,805,40,228,663,6526,55,45,6626,49,49,100.0,Kast
2021-11-26 16:43:19.306967,2584,3724,2891,1517,1479,153,1348,2238,13350,166,65,13581,80,80,100.0,Boric
2021-11-26 16:43:19.306967,2741,129,150,80,43,4,18,68,492,2,5,499,6,6,100.0,Kast
2021-11-26 16:43:19.306967,2560,1454,1725,762,778,59,644,1894,7316,72,34,7422,46,46,100.0,Parisi
2021-11-26 16:43:19.306967,2735,628,1041,600,389,48,223,678,3607,51,70,3728,29,29,100.0,Kast
2021-11-26 16:43:19.306967,2626,817,992,1017,660,40,259,366,4151,37,30,4218,32,32,100.0,Provoste
2021-11-26 16:43:19.306967,2653,8184,9966,4598,3718,523,3421,8834,39244,290,116,39650,244,244,100.0,Kast
2021-11-26 16:43:19.306967,2646,1433,2304,1063,823,103,847,1802,8375,94,66,8535,63,63,100.0,Kast
2021-11-26 16:43:19.306967,2506,207,479,157,88,12,78,667,1688,21,16,1725,36,36,100.0,Parisi
2021-11-26 16:43:19.306967,2525,641,538,1309,196,58,193,930,3865,33,15,3913,25,25,100.0,Provoste
2021-11-26 16:43:19.306967,2764,11004,9452,4524,6760,771,4067,3205,39783,308,158,40249,223,223,100.0,Boric
2021-11-26 16:43:19.306967,2532,3146,1953,2104,1061,150,746,2738,11898,82,70,12050,82,82,100.0,Boric
2021-11-26 16:43:19.306967,2765,11569,8327,3414,4646,749,2802,2076,33583,208,97,33888,246,246,100.0,Boric
2021-11-26 16:43:19.306967,2501,15561,24111,6038,6581,976,4687,15753,73707,556,229,74492,616,616,100.0,Kast
2021-11-26 16:43:19.306967,2807,3466,3638,1827,1733,199,1367,1505,13735,98,70,13903,83,83,100.0,Kast
2021-11-26 16:43:19.306967,2548,972,581,352,314,41,323,311,2894,60,73,3027,19,19,100.0,Boric
2021-11-26 16:43:19.306967,2544,144,61,37,42,5,22,6,317,1,3,321,3,3,100.0,Boric
2021-11-26 16:43:19.306967,2766,13048,9830,4101,5577,733,3410,2561,39260,308,78,39646,259,259,100.0,Boric
2021-11-26 16:43:19.306967,2561,2124,2639,808,1249,100,646,1616,9182,53,17,9252,49,49,100.0,Kast
2021-11-26 16:43:19.306967,2597,406,514,326,301,19,113,128,1807,12,24,1843,15,15,100.0,Kast
2021-11-26 16:43:19.306967,2767,58280,33562,16861,23602,3003,13959,10735,160002,1081,431,161514,918,918,100.0,Boric
2021-11-26 16:43:19.306967,2768,14887,8105,5911,4555,1002,5652,4742,44854,367,132,45353,318,318,100.0,Boric
2021-11-26 16:43:19.306967,2529,459,322,296,109,30,116,406,1738,23,26,1787,14,14,100.0,Boric
2021-11-26 16:43:19.306967,2553,4229,3165,1896,1680,195,1079,2257,14501,114,59,14674,92,92,100.0,Boric
2021-11-26 16:43:19.306967,2769,16058,9033,7562,4581,1240,9026,7371,54871,559,274,55704,508,508,100.0,Boric
2021-11-26 16:43:19.306967,2770,15721,17036,6293,13727,574,1779,1222,56352,290,150,56792,283,283,100.0,Kast
2021-11-26 16:43:19.306967,2526,23116,20297,9044,10034,1218,5562,13763,83034,532,255,83821,524,524,100.0,Boric
2021-11-26 16:43:19.306967,2818,2783,5954,2321,1840,163,763,2212,16036,110,105,16251,110,110,100.0,Kast
2021-11-26 16:43:19.306967,2820,703,1740,655,475,51,188,487,4299,67,64,4430,37,37,100.0,Kast
2021-11-26 16:43:19.306967,2738,75,216,65,46,11,16,31,460,11,5,476,5,5,100.0,Kast
2021-11-26 16:43:19.306967,2748,57,134,33,24,3,26,25,302,2,2,306,3,3,100.0,Kast
2021-11-26 16:43:19.306967,2664,1299,2710,1013,880,83,632,2295,8912,118,64,9094,65,65,100.0,Kast
2021-11-26 16:43:19.306967,2794,7393,7309,2752,3677,456,3219,4002,28808,212,121,29141,187,187,100.0,Boric
2021-11-26 16:43:19.306967,2812,1413,2312,981,561,78,309,1000,6654,59,69,6782,50,50,100.0,Kast
2021-11-26 16:43:19.306967,2585,1993,2392,1471,1282,104,779,835,8856,95,97,9048,65,65,100.0,Kast
2021-11-26 16:43:19.306967,2771,22095,78095,12345,53090,598,2553,1826,170602,716,343,171661,803,803,100.0,Kast
2021-11-26 16:43:19.306967,2682,2171,6920,2197,1281,144,785,1829,15327,169,96,15592,102,102,100.0,Kast
2021-11-26 16:43:19.306967,2654,1581,3442,1361,527,95,647,1238,8891,115,80,9086,67,67,100.0,Kast
2021-11-26 16:43:19.306967,2627,562,735,539,628,29,187,347,3027,15,12,3054,24,24,100.0,Kast
2021-11-26 16:43:19.306967,2576,5243,5735,1791,2418,280,1295,2555,19317,170,79,19566,117,117,100.0,Kast
2021-11-26 16:43:19.306967,2634,7895,12574,4137,4493,318,2377,4913,36707,288,157,37152,241,241,100.0,Kast
2021-11-26 16:43:19.306967,2598,673,935,615,470,31,200,208,3132,26,28,3186,22,22,100.0,Kast
2021-11-26 16:43:19.306967,2571,2900,1688,1441,1006,169,974,2060,10238,125,49,10412,62,62,100.0,Boric
2021-11-26 16:43:19.306967,2713,1395,2618,1190,627,66,548,1390,7834,63,70,7967,48,48,100.0,Kast
2021-11-26 16:43:19.306967,2772,4617,28309,2570,16644,200,1249,1189,54778,164,102,55044,248,248,100.0,Kast
2021-11-26 16:43:19.306967,2773,12548,6383,4582,3233,923,5690,4296,37655,298,164,38117,305,305,100.0,Boric
2021-11-26 16:43:19.306967,2774,12923,7554,4785,4389,910,5272,3878,39711,449,166,40326,272,272,100.0,Boric
2021-11-26 16:43:19.306967,2605,568,812,654,569,18,120,228,2969,18,39,3026,21,21,100.0,Kast
2021-11-26 16:43:19.306967,2683,1516,3501,1537,938,93,588,1306,9479,87,74,9640,76,76,100.0,Kast
2021-11-26 16:43:19.306967,2636,1644,4182,1414,1186,56,518,1077,10077,87,66,10230,79,79,100.0,Kast
2021-11-26 16:43:19.306967,2700,580,2144,880,326,32,169,427,4558,81,98,4737,40,40,100.0,Kast
2021-11-26 16:43:19.306967,2659,1027,3497,1073,477,78,380,1267,7799,80,63,7942,58,58,100.0,Kast
2021-11-26 16:43:19.306967,2549,7177,7144,3240,3590,330,2268,5369,29118,279,122,29519,166,166,100.0,Boric
2021-11-26 16:43:19.306967,2661,9448,29438,6438,8842,615,3254,11658,69693,498,344,70535,556,556,100.0,Kast
2021-11-26 16:43:19.306967,2813,1476,2851,1055,698,60,396,1091,7627,72,60,7759,62,62,100.0,Kast
2021-11-26 16:43:19.306967,2712,796,3214,858,715,37,245,759,6624,69,124,6817,49,49,100.0,Kast
2021-11-26 16:43:19.306967,2701,386,1881,462,310,28,130,277,3474,48,49,3571,26,26,100.0,Kast
2021-11-26 16:43:19.306967,2534,2142,1431,1331,801,150,659,1345,7859,75,42,7976,57,57,100.0,Boric
2021-11-26 16:43:19.306967,2647,3893,6204,3074,1290,232,1838,4586,21117,283,142,21542,147,147,100.0,Kast
2021-11-26 16:43:19.306967,2702,556,2443,454,227,52,175,241,4148,42,51,4241,35,35,100.0,Kast
2021-11-26 16:43:19.306967,2586,5093,5586,1848,3171,172,1619,2884,20373,165,93,20631,114,114,100.0,Kast
2021-11-26 16:43:19.306967,2775,19448,11868,5998,8391,963,4314,3103,54085,350,139,54574,370,370,100.0,Boric
2021-11-26 16:43:19.306967,2814,479,1292,423,283,29,187,647,3340,38,39,3417,24,24,100.0,Kast
2021-11-26 16:43:19.306967,2776,75642,42676,19369,25976,4162,20920,17660,206405,1426,600,208431,1186,1186,100.0,Boric
2021-11-26 16:43:19.306967,2587,1064,1691,794,682,43,414,686,5374,63,25,5462,43,43,100.0,Kast
2021-11-26 16:43:19.306967,2599,669,755,595,605,33,171,240,3068,15,21,3104,22,22,100.0,Kast
2021-11-26 16:43:19.306967,2516,265,212,148,73,34,118,964,1814,58,8,1880,23,23,100.0,Parisi
2021-11-26 16:43:19.306967,2803,1507,1503,750,793,52,419,485,5509,30,32,5571,35,35,100.0,Boric
2021-11-26 16:43:19.306967,2815,1520,2346,1226,667,72,391,1543,7765,71,61,7897,64,64,100.0,Kast
2021-11-26 16:43:19.306967,2616,2117,3418,1525,1544,94,968,2339,12005,109,82,12196,78,78,100.0,Kast
2021-11-26 16:43:19.306967,2714,882,2197,941,496,50,208,715,5489,45,60,5594,58,58,100.0,Kast
2021-11-26 16:43:19.306967,2509,747,589,350,200,52,270,1656,3864,30,15,3909,30,30,100.0,Parisi
2021-11-26 16:43:19.306967,2684,362,944,328,199,26,95,247,2201,29,20,2250,23,23,100.0,Kast
2021-11-26 16:43:19.306967,2800,10619,12241,4809,5548,590,2810,4324,40941,335,190,41466,286,286,100.0,Kast
2021-11-26 16:43:19.306967,2628,3961,4884,3244,2253,185,1647,2641,18815,198,118,19131,119,119,100.0,Kast
2021-11-26 16:43:19.306967,2538,1972,1896,1837,794,185,748,2596,10028,115,80,10223,102,102,100.0,Parisi
2021-11-26 16:43:19.306967,2588,2657,2281,1117,1063,128,856,1594,9696,104,53,9853,64,64,100.0,Boric
2021-11-26 16:43:19.306967,2665,1351,3762,1613,822,86,465,1830,9929,104,117,10150,79,79,100.0,Kast
2021-11-26 16:43:19.306967,2666,1367,3693,1264,836,91,477,2874,10602,84,72,10758,72,72,100.0,Kast
2021-11-26 16:43:19.306967,2606,1332,1661,1276,1064,60,395,1006,6794,44,43,6881,45,45,100.0,Kast
2021-11-26 16:43:19.306967,2756,2437,2039,1253,573,91,714,997,8104,105,72,8281,69,69,100.0,Boric
2021-11-26 16:43:19.306967,2600,807,761,622,527,53,217,204,3191,27,28,3246,21,21,100.0,Boric
2021-11-26 16:43:19.306967,2667,350,1545,508,399,25,217,661,3705,49,44,3798,30,30,100.0,Kast
2021-11-26 16:43:19.306967,2838,253,824,695,325,15,105,191,2408,24,22,2454,21,21,100.0,Kast
2021-11-26 16:43:19.306967,2562,2325,1501,1094,925,130,899,2388,9262,60,55,9377,66,66,100.0,Parisi
2021-11-26 16:43:19.306967,2685,2196,4697,2301,1191,178,1011,1647,13221,164,102,13487,91,91,100.0,Kast
2021-11-26 16:43:19.306967,2844,531,2000,632,610,35,301,518,4627,46,58,4731,34,34,100.0,Kast
2021-11-26 16:43:19.306967,2777,48160,29426,12316,23111,1822,4561,2750,122146,601,276,123023,616,616,100.0,Boric
2021-11-26 16:43:19.306967,2743,75,142,47,26,3,5,16,314,5,6,325,3,3,100.0,Kast
2021-11-26 16:43:19.306967,2589,1324,1701,718,835,46,493,1076,6193,55,32,6280,42,42,100.0,Kast
2021-11-26 16:43:19.306967,2513,29,53,25,12,3,27,220,369,2,1,372,6,6,100.0,Parisi
2021-11-26 16:43:19.306967,2577,1925,2624,760,1000,101,561,893,7864,69,44,7977,49,49,100.0,Kast
2021-11-26 16:43:19.306967,2726,14256,21365,9974,7727,838,3308,9893,67361,496,238,68095,459,459,100.0,Kast
2021-11-26 16:43:19.306967,2536,8759,7746,5571,3740,420,2765,7672,36673,310,192,37175,273,273,100.0,Boric
2021-11-26 16:43:19.306967,2808,7120,5178,2626,2775,418,3123,3527,24767,195,87,25049,136,136,100.0,Boric
2021-11-26 16:43:19.306967,2686,4409,9271,2982,2511,265,1852,4368,25658,260,185,26103,175,175,100.0,Kast
2021-11-26 16:43:19.306967,2530,576,488,289,274,37,146,277,2087,17,14,2118,16,16,100.0,Boric
2021-11-26 16:43:19.306967,2816,1428,3333,1171,802,94,333,1226,8387,81,73,8541,66,66,100.0,Kast
2021-11-26 16:43:19.306967,2799,7020,8429,2699,2743,266,2099,3212,26468,208,125,26801,166,166,100.0,Kast
2021-11-26 16:43:19.306967,2736,160,307,157,81,7,20,57,789,8,14,811,7,7,100.0,Kast
2021-11-26 16:43:19.306967,2607,819,1127,1231,671,39,275,469,4631,32,40,4703,31,31,100.0,Provoste
2021-11-26 16:43:19.306967,2817,2368,4899,1954,1329,169,896,1835,13450,204,164,13818,108,108,100.0,Kast
2021-11-26 16:43:19.306967,2572,714,870,389,331,28,229,711,3272,33,25,3330,20,20,100.0,Kast
2021-11-26 16:43:19.306967,2555,869,904,497,658,34,195,458,3615,14,10,3639,22,22,100.0,Kast
2021-11-26 16:43:19.306967,2601,634,752,708,523,24,155,217,3013,28,53,3094,24,24,100.0,Kast
2021-11-26 16:43:19.306967,2637,2752,6504,2394,2552,109,829,1551,16691,156,108,16955,128,128,100.0,Kast
2021-11-26 16:43:19.306967,2778,17002,7566,5047,4532,1400,5661,3541,44749,396,288,45433,337,337,100.0,Boric
2021-11-26 16:43:19.306967,2617,549,1127,595,528,29,248,561,3637,41,15,3693,26,26,100.0,Kast
2021-11-26 16:43:19.306967,2624,692,1813,531,499,34,179,274,4022,66,36,4124,26,26,100.0,Kast
2021-11-26 16:43:19.306967,2830,424,1364,574,423,20,172,390,3367,29,13,3409,29,29,100.0,Kast
2021-11-26 16:43:19.306967,2618,634,1686,936,656,24,269,584,4789,168,42,4999,37,37,100.0,Kast
2021-11-26 16:43:19.306967,2648,4384,4823,3466,1798,299,1652,4424,20846,176,110,21132,125,125,100.0,Kast
2021-11-26 16:43:19.306967,2809,10886,7694,4238,4229,599,4264,5103,37013,290,132,37435,215,215,100.0,Boric
2021-11-26 16:43:19.306967,2779,30779,19456,11182,14942,1664,9789,7119,94931,685,342,95958,582,582,100.0,Boric
2021-11-26 16:43:19.306967,2608,915,1092,921,772,40,273,392,4405,21,17,4443,30,30,100.0,Kast
2021-11-26 16:43:19.306967,2687,383,1252,458,174,36,186,456,2945,39,22,3006,21,21,100.0,Kast
2021-11-26 16:43:19.306967,2556,1175,671,712,361,54,374,742,4089,48,30,4167,30,30,100.0,Boric
2021-11-26 16:43:19.306967,2590,1500,1260,985,770,84,505,791,5895,67,68,6030,39,39,100.0,Boric
2021-11-26 16:43:19.306967,2507,403,758,305,203,27,100,743,2539,16,10,2565,21,22,95.455,Kast
2021-11-26 16:43:19.306967,2591,1541,1614,1232,1138,83,464,745,6817,48,90,6955,50,50,100.0,Kast
2021-11-26 16:43:19.306967,2596,2210,1996,1173,1577,118,560,733,8367,78,55,8500,49,49,100.0,Boric
2021-11-26 16:43:19.306967,2831,578,2626,457,726,34,256,446,5123,38,38,5199,37,37,100.0,Kast
2021-11-26 16:43:19.306967,2791,3587,3614,1504,1992,151,1025,849,12722,85,44,12851,80,80,100.0,Kast
2021-11-26 16:43:19.306967,2688,1573,4487,1243,974,82,572,1077,10008,77,46,10131,69,69,100.0,Kast
2021-11-26 16:43:19.306967,2609,643,977,722,580,47,282,636,3887,42,33,3962,25,25,100.0,Kast
2021-11-26 16:43:19.306967,2839,308,1068,574,371,23,116,207,2667,29,22,2718,23,23,100.0,Kast
2021-11-26 16:43:19.306967,2753,761,581,304,166,18,193,245,2268,39,19,2326,20,20,100.0,Boric
2021-11-26 16:43:19.306967,2503,544,1260,664,229,58,276,2049,5080,46,29,5155,47,47,100.0,Parisi
2021-11-26 16:43:19.306967,2754,63,66,43,31,4,46,51,304,7,2,313,4,4,100.0,Kast
2021-11-26 16:43:19.306967,2780,29002,30223,10313,22196,833,2063,1302,95932,416,196,96544,508,508,100.0,Kast
2021-11-26 16:43:19.306967,2545,2319,1920,907,1357,126,793,1357,8779,64,27,8870,65,65,100.0,Boric
2021-11-26 16:43:19.306967,2689,2900,4593,1089,1595,136,595,1352,12260,93,57,12410,86,86,100.0,Kast
2021-11-26 16:43:19.306967,2781,26745,15263,8275,8815,2028,10562,8610,80298,646,262,81206,510,510,100.0,Boric
2021-11-26 16:43:19.306967,2790,68957,33904,18243,23315,4075,22299,19351,190144,1748,546,192438,1276,1276,100.0,Boric
2021-11-26 16:43:19.306967,2707,18811,28790,9339,9459,1222,5524,14478,87623,650,498,88771,573,573,100.0,Kast
2021-11-26 16:43:19.306967,2727,651,1248,956,318,42,201,645,4061,29,27,4117,30,30,100.0,Kast
2021-11-26 16:43:19.306967,2715,4459,9205,2276,3836,190,897,2151,23014,132,122,23268,128,128,100.0,Kast
2021-11-26 16:43:19.306967,2610,356,534,383,346,27,133,125,1904,8,17,1929,13,13,100.0,Kast
2021-11-26 16:43:19.306967,2539,819,682,709,296,31,262,1244,4043,44,45,4132,32,32,100.0,Parisi
2021-11-26 16:43:19.306967,2747,17375,15588,5003,4781,537,5472,7174,55930,474,193,56597,400,400,100.0,Boric
2021-11-26 16:43:19.306967,2721,299,287,217,102,14,83,293,1295,23,12,1330,14,14,100.0,Boric
2021-11-26 16:43:19.306967,2703,615,2644,924,398,49,230,405,5265,44,32,5341,39,39,100.0,Kast
2021-11-26 16:43:19.306967,2728,1317,3456,1691,882,79,423,1082,8930,104,89,9123,71,71,100.0,Kast
2021-11-26 16:43:19.306967,2573,1807,1382,1031,628,119,536,944,6447,64,36,6547,42,42,100.0,Boric
2021-11-26 16:43:19.306967,2824,179,658,268,91,20,88,648,1952,23,26,2001,19,19,100.0,Kast
2021-11-26 16:43:19.306967,2729,753,1790,1151,413,42,267,598,5014,45,38,5097,35,35,100.0,Kast
2021-11-26 16:43:19.306967,2722,493,520,663,212,29,117,315,2349,20,34,2403,19,19,100.0,Provoste
2021-11-26 16:43:19.306967,2723,1748,2123,1660,694,111,441,1747,8524,112,146,8782,70,70,100.0,Kast
2021-11-26 16:43:19.306967,2724,587,789,596,291,30,145,345,2783,27,55,2865,34,34,100.0,Kast
2021-11-26 16:43:19.306967,2668,235,668,409,194,11,79,233,1829,13,26,1868,15,15,100.0,Kast
2021-11-26 16:43:19.306967,2782,22630,12966,6869,8028,1458,8281,8671,68903,657,186,69746,418,418,100.0,Boric
2021-11-26 16:43:19.306967,2669,410,1479,572,399,43,244,675,3822,59,50,3931,34,34,100.0,Kast
2021-11-26 16:43:19.306967,2832,839,2479,996,827,71,420,970,6602,68,37,6707,49,49,100.0,Kast
2021-11-26 16:43:19.306967,2558,9253,9930,3514,4514,565,3009,5680,36465,298,116,36879,223,223,100.0,Kast
2021-11-26 16:43:19.306967,2575,20730,19866,6164,8511,1075,5615,8245,70206,515,188,70909,398,398,100.0,Boric
2021-11-26 16:43:19.306967,2725,712,515,626,191,25,127,276,2472,29,33,2534,32,32,100.0,Boric
2021-11-26 16:43:19.306967,2592,1464,1441,782,784,72,420,810,5773,60,59,5892,37,37,100.0,Boric
2021-11-26 16:43:19.306967,2783,15938,9937,4830,5451,1068,5075,3301,45600,362,128,46090,304,304,100.0,Boric
2021-11-26 16:43:19.306967,2546,3086,2997,1165,1237,186,1281,2288,12240,89,56,12385,74,74,100.0,Boric
2021-11-26 16:43:19.306967,2835,758,1357,1337,704,43,244,594,5037,78,85,5200,37,37,100.0,Kast
2021-11-26 16:43:19.306967,2579,25622,22687,9012,11856,1141,7901,16075,94294,780,287,95361,574,574,100.0,Boric
2021-11-26 16:43:19.306967,2840,356,991,507,321,19,144,381,2719,23,22,2764,20,20,100.0,Kast
2021-11-26 16:43:19.306967,2629,602,1474,722,567,37,383,526,4311,47,29,4387,29,29,100.0,Kast
2021-11-26 16:43:19.306967,2784,21859,13211,6495,7216,1547,6377,4634,61339,485,234,62058,466,466,100.0,Boric
2021-11-26 16:43:19.306967,2704,445,1755,576,385,35,259,792,4247,68,32,4347,36,36,100.0,Kast
2021-11-26 16:43:19.306967,2785,16061,8927,5984,4860,1280,7297,6237,50646,571,185,51402,346,346,100.0,Boric
2021-11-26 16:43:19.306967,2593,5573,5561,3314,2540,298,2182,3461,22929,255,166,23350,149,149,100.0,Boric
2021-11-26 16:43:19.306967,2594,2120,3401,1398,1380,107,909,2143,11458,96,223,11777,69,69,100.0,Kast
2021-11-26 16:43:19.306967,2638,908,2962,933,1226,55,400,737,7221,71,89,7381,52,52,100.0,Kast
2021-11-26 16:43:19.306967,2551,1097,1415,710,644,63,375,863,5167,24,27,5218,28,28,100.0,Kast
2021-11-26 16:43:19.306967,2821,2106,5283,2025,1380,150,583,1673,13200,134,263,13597,103,103,100.0,Kast
2021-11-26 16:43:19.306967,2619,856,1688,827,820,60,433,726,5410,91,78,5579,36,36,100.0,Kast
2021-11-26 16:43:19.306967,2540,327,365,396,195,20,124,326,1753,23,13,1789,18,18,100.0,Provoste
2021-11-26 16:43:19.306967,2746,287,464,227,161,11,69,112,1331,25,29,1385,12,12,100.0,Kast
2021-11-26 16:43:19.306967,2730,891,2158,1314,703,50,290,827,6233,66,44,6343,46,46,100.0,Kast
2021-11-26 16:43:19.306967,2749,52,101,17,26,0,29,31,256,2,0,258,3,3,100.0,Kast
2021-11-26 16:43:19.306967,2630,1049,2145,1045,896,62,462,742,6401,52,49,6502,41,41,100.0,Kast
2021-11-26 16:43:19.306967,2690,760,1581,1183,453,106,406,535,5024,103,73,5200,40,40,100.0,Kast
2021-11-26 16:43:19.306967,2631,1303,1966,1466,974,72,557,962,7300,67,63,7430,50,50,100.0,Kast
2021-11-26 16:43:19.306967,2535,2134,2017,1610,832,141,577,2512,9823,85,73,9981,71,71,100.0,Parisi
2021-11-26 16:43:19.306967,2563,11916,6985,5075,3455,1038,4312,5914,38695,323,139,39157,232,232,100.0,Boric
2021-11-26 16:43:19.306967,2796,29945,23430,10008,10215,1693,11303,10992,97586,802,342,98730,679,679,100.0,Boric
2021-11-26 16:43:19.306967,2842,3118,7864,2526,2391,161,942,2335,19337,166,148,19651,142,142,100.0,Kast
2021-11-26 16:43:19.306967,2620,2686,4207,2601,1749,134,1105,2266,14748,183,119,15050,110,110,100.0,Kast
2021-11-26 16:43:19.306967,2552,1726,1816,1240,1006,93,594,1793,8268,90,43,8401,45,45,100.0,Kast
2021-11-26 16:43:19.306967,2845,394,805,392,308,14,97,281,2291,25,22,2338,17,17,100.0,Kast
2021-11-26 16:43:19.306967,2569,7691,7542,3280,3253,425,2200,5113,29504,239,132,29875,178,178,100.0,Boric
2021-11-26 16:43:19.306967,2602,7173,8385,3836,4240,372,2136,4055,30197,259,150,30606,187,187,100.0,Kast
2021-11-26 16:43:19.306967,2750,52,95,5,32,0,27,33,244,2,3,249,2,2,100.0,Kast
2021-11-26 16:43:19.306967,2833,730,2504,906,892,59,389,619,6099,67,56,6222,52,52,100.0,Kast
2021-11-26 16:43:19.306967,2639,2720,5319,2501,2086,135,979,2139,15879,121,119,16119,117,117,100.0,Kast
2021-11-26 16:43:19.306967,2786,14987,6971,4401,4367,953,4246,3042,38967,321,143,39431,263,263,100.0,Boric
2021-11-26 16:43:19.306967,2792,2878,1617,1022,940,163,771,569,7960,98,34,8092,48,48,100.0,Boric
2021-11-26 16:43:19.306967,2731,746,838,1228,328,66,231,518,3955,51,31,4037,32,32,100.0,Provoste
2021-11-26 16:43:19.306967,2787,19876,12313,5296,8201,1035,3600,2401,52722,289,100,53111,313,313,100.0,Boric
2021-11-26 16:43:19.306967,2846,785,1849,906,640,47,403,691,5321,59,52,5432,36,36,100.0,Kast
2021-11-26 16:43:19.306967,2732,757,1566,1158,454,55,254,544,4788,52,33,4873,31,31,100.0,Kast
2021-11-26 16:43:19.306967,2804,671,1332,541,483,34,195,312,3568,36,28,3632,25,25,100.0,Kast
2021-11-26 16:43:19.306967,2514,849,453,370,187,66,215,1103,3243,42,25,3310,22,22,100.0,Parisi
2021-11-26 16:43:19.306967,2649,9865,14414,4764,6613,489,2926,7277,46348,277,139,46764,270,270,100.0,Kast
2021-11-26 16:43:19.306967,2621,590,1183,627,548,38,369,738,4093,43,32,4168,26,26,100.0,Kast
2021-11-26 16:43:19.306967,2788,10640,6373,4068,3468,844,4739,3581,33713,308,165,34186,251,251,100.0,Boric
2021-11-26 16:43:19.306967,2670,313,510,282,134,13,204,431,1887,28,18,1933,15,15,100.0,Kast
2021-11-26 16:43:19.306967,2595,4515,4736,3166,2779,218,1237,2040,18691,293,102,19086,133,133,100.0,Kast
2021-11-26 16:43:19.306967,2671,645,2082,670,583,47,225,865,5117,46,38,5201,39,39,100.0,Kast
2021-11-26 16:43:19.306967,2611,3012,3809,2049,2537,130,664,1291,13492,85,61,13638,92,92,100.0,Kast
2021-11-26 16:43:19.306967,2650,886,2155,638,424,71,341,847,5362,55,39,5456,39,39,100.0,Kast
2021-11-26 16:43:19.306967,2574,1149,1343,1017,770,59,449,1141,5928,85,42,6055,36,36,100.0,Kast
2021-11-26 16:43:19.306967,2758,53453,34459,12577,18640,3060,7131,5754,135074,911,400,136385,1049,1049,100.0,Boric
2021-11-26 16:43:19.306967,2568,1281,3000,828,1333,58,395,503,7398,46,22,7466,35,35,100.0,Kast
2021-11-26 16:43:19.306967,2510,102,132,79,27,5,61,234,640,4,0,644,9,9,100.0,Parisi
2021-11-26 16:43:19.306967,2805,8298,8109,3668,3722,460,2986,3808,31051,278,147,31476,173,173,100.0,Boric
2021-11-26 16:43:19.306967,2612,22153,25367,11031,12867,955,5819,13390,91582,685,275,92542,532,532,100.0,Kast
2021-11-26 16:43:19.306967,2651,13213,18990,6191,6103,866,4567,13115,63045,507,189,63741,465,465,100.0,Kast
2021-11-26 16:43:19.306967,2511,851,720,602,188,56,273,906,3596,33,22,3651,31,31,100.0,Parisi
2021-11-26 16:43:19.306967,2675,23413,47003,12020,14168,1206,6787,15121,119718,796,367,120881,904,904,100.0,Kast
2021-11-26 16:43:19.306967,2632,1684,3127,1228,1377,105,776,1440,9737,103,80,9920,73,73,100.0,Kast
2021-11-26 16:43:19.306967,2691,749,2667,911,995,46,302,656,6326,107,96,6529,52,52,100.0,Kast
2021-11-26 16:43:19.306967,2519,849,737,1163,318,45,279,1616,5007,43,23,5073,43,43,100.0,Parisi
2021-11-26 16:43:19.306967,2795,1980,1741,767,906,106,643,968,7111,69,27,7207,54,54,100.0,Boric
2021-11-26 16:43:19.306967,2755,24,71,8,19,1,23,22,168,2,1,171,3,3,100.0,Kast
2021-11-26 16:43:19.306967,2660,581,1936,483,234,57,140,322,3753,47,44,3844,27,27,100.0,Kast
2021-11-26 16:43:19.306967,2515,1508,1189,913,477,105,651,3444,8287,77,34,8398,69,69,100.0,Parisi
2021-11-26 16:43:19.306967,2692,565,1858,631,645,44,254,460,4457,66,59,4582,33,33,100.0,Kast
2021-11-26 16:43:19.306967,2652,4959,6873,3324,2073,251,1424,3804,22708,200,128,23036,158,158,100.0,Kast
2021-11-26 16:43:19.306967,2757,123,161,123,42,4,67,74,594,8,8,610,6,6,100.0,Kast
2021-11-26 16:43:19.306967,2744,67,39,35,20,8,15,14,198,10,7,215,2,2,100.0,Boric
2021-11-26 16:43:19.306967,2705,1273,3830,991,753,105,431,519,7902,113,66,8081,65,65,100.0,Kast
2021-11-26 16:43:19.306967,2841,398,905,557,310,20,117,338,2645,22,27,2694,20,20,100.0,Kast
2021-11-26 16:43:19.306967,2672,830,1820,939,584,53,305,1148,5679,60,61,5800,47,47,100.0,Kast
2021-11-26 16:43:19.306967,2810,21119,19546,8563,7402,1092,4257,8081,70060,509,279,70848,412,412,100.0,Boric
2021-11-26 16:43:19.306967,2522,2806,2780,8579,1104,173,519,3901,19862,112,65,20039,135,135,100.0,Provoste
2021-11-26 16:43:19.306967,2541,45684,30484,12931,12302,3301,11393,13507,129602,1129,438,131169,940,940,100.0,Boric
2021-11-26 16:43:19.306967,2633,398,855,414,757,25,107,186,2742,16,24,2782,21,21,100.0,Kast
2021-11-26 16:43:19.306967,2706,1718,8472,1477,1142,121,740,1029,14699,127,80,14906,111,111,100.0,Kast
2021-11-26 16:43:19.306967,2531,2255,1745,1968,822,124,537,1672,9123,119,62,9304,70,70,100.0,Boric
2021-11-26 16:43:19.306967,2693,1444,4473,1605,1208,100,548,1301,10679,116,84,10879,75,75,100.0,Kast
2021-11-26 16:43:19.306967,2640,964,2056,937,845,42,396,636,5876,56,39,5971,41,41,100.0,Kast
2021-11-26 16:43:19.306967,2578,14351,15343,4365,5754,852,3950,6545,51160,366,125,51651,293,293,100.0,Kast
2021-11-26 16:43:19.306967,2694,5166,9997,2577,2858,288,1185,2722,24793,183,131,25107,165,165,100.0,Kast
2021-11-26 16:43:19.306967,2547,41778,47235,13555,20944,2319,9962,13873,149666,964,401,151031,947,947,100.0,Kast
2021-11-26 16:43:19.306967,2789,4455,31215,3596,20938,110,401,254,60969,206,110,61285,265,265,100.0,Kast
2021-11-26 16:43:19.306967,2641,934,2247,1070,726,68,485,742,6272,92,77,6441,47,47,100.0,Kast
2021-11-26 16:43:19.306967,2673,1381,3275,1242,794,86,472,1356,8606,89,72,8767,68,68,100.0,Kast
2021-11-26 16:43:19.306967,2834,1181,1930,1148,681,70,388,1351,6749,65,49,6863,49,49,100.0,Kast
2021-11-26 16:43:19.306967,2557,1069,1831,467,1311,38,269,430,5415,31,15,5461,28,28,100.0,Kast
