ts,circelec,idservel,mex,c1,c2,c3,c4,c5,c6,c7,vv,vn,vb,vt,me,tm,cm,w1V
2021-12-05 05:24:46.923710,9053,2851,True,7,1,1,0,0,2,0,11,0,0,11,1,1,100.0,Boric
2021-12-05 05:24:46.923710,9088,2882,True,5,1,2,3,0,0,0,11,0,0,11,1,1,100.0,Boric
2021-12-05 05:24:46.923710,9091,2884,True,2,3,2,0,0,0,0,7,0,0,7,1,1,100.0,Kast
2021-12-05 05:24:46.923710,9111,2905,True,5,10,0,3,0,0,0,18,0,0,18,1,1,100.0,Kast
2021-12-05 05:24:46.923710,9006,2819,True,37,37,12,3,2,12,3,106,3,0,109,2,2,100.0,Boric
2021-12-05 05:24:46.923710,9007,2824,True,56,25,13,5,2,16,8,125,3,0,128,2,2,100.0,Boric
2021-12-05 05:24:46.923710,9008,2817,True,736,168,61,66,53,33,32,1149,9,3,1161,7,7,100.0,Boric
2021-12-05 05:24:46.923710,9009,2816,True,26,16,7,4,1,9,1,64,0,0,64,1,1,100.0,Boric
2021-12-05 05:24:46.923710,9010,2822,True,68,22,6,9,4,5,2,116,0,0,116,1,1,100.0,Boric
2021-12-05 05:24:46.923710,9012,2820,True,39,28,10,6,4,6,5,98,1,0,99,1,1,100.0,Boric
2021-12-05 05:24:46.923710,9013,2815,True,125,59,34,20,3,13,6,260,3,0,263,3,3,100.0,Boric
2021-12-05 05:24:46.923710,9014,2825,True,115,63,43,12,5,14,13,265,0,1,266,5,5,100.0,Boric
2021-12-05 05:24:46.923710,9015,2826,True,24,13,9,4,0,9,3,62,4,2,68,1,1,100.0,Boric
2021-12-05 05:24:46.923710,9016,2818,True,34,17,7,8,1,7,2,76,0,0,76,2,2,100.0,Boric
2021-12-05 05:24:46.923710,9017,2827,True,53,17,6,6,2,7,1,92,0,0,92,1,1,100.0,Boric
2021-12-05 05:24:46.923710,9018,2823,True,11,15,4,2,0,2,2,36,1,0,37,1,1,100.0,Kast
2021-12-05 05:24:46.923710,9020,2915,True,39,9,16,7,2,7,4,84,2,0,86,1,1,100.0,Boric
2021-12-05 05:24:46.923710,9021,2916,True,19,7,4,4,3,1,2,40,1,0,41,1,1,100.0,Boric
2021-12-05 05:24:46.923710,9022,2821,True,14,10,5,1,1,4,1,36,1,0,37,1,1,100.0,Boric
2021-12-05 05:24:46.923710,9122,2922,True,8,54,4,7,2,1,6,82,0,1,83,1,1,100.0,Kast
2021-12-05 05:24:46.923710,9029,2833,True,17,46,1,4,2,1,3,74,0,0,74,1,1,100.0,Kast
2021-12-05 05:24:46.923710,9030,2834,True,21,109,18,9,0,4,4,165,1,0,166,1,1,100.0,Kast
2021-12-05 05:24:46.923710,9031,2835,True,35,28,4,8,0,1,3,79,1,0,80,1,1,100.0,Boric
2021-12-05 05:24:46.923710,9032,2836,True,20,14,6,7,1,1,3,52,0,0,52,1,1,100.0,Boric
2021-12-05 05:24:46.923710,9033,2837,True,72,42,11,11,1,4,2,143,0,0,143,1,1,100.0,Boric
2021-12-05 05:24:46.923710,9034,2838,True,178,104,22,18,4,2,11,339,0,2,341,4,4,100.0,Boric
2021-12-05 05:24:46.923710,9036,2918,True,135,21,4,7,5,4,11,187,0,1,188,1,1,100.0,Boric
2021-12-05 05:24:46.923710,9037,2841,True,713,110,75,52,31,41,44,1066,2,0,1068,6,6,100.0,Boric
2021-12-05 05:24:46.923710,9038,2840,True,71,31,10,17,4,2,5,140,0,0,140,1,1,100.0,Boric
2021-12-05 05:24:46.923710,9039,2842,True,536,136,52,81,30,22,35,892,1,0,893,5,5,100.0,Boric
2021-12-05 05:24:46.923710,9040,2839,True,330,62,23,54,8,10,24,511,4,0,515,3,3,100.0,Boric
2021-12-05 05:24:46.923710,9041,2919,True,75,10,2,6,2,10,0,105,0,0,105,1,1,100.0,Boric
2021-12-05 05:24:46.923710,9046,2843,True,54,96,14,40,1,7,4,216,0,0,216,1,1,100.0,Kast
2021-12-05 05:24:46.923710,9047,2845,True,128,89,19,35,3,4,8,286,2,0,288,2,2,100.0,Boric
2021-12-05 05:24:46.923710,9049,2847,True,45,1,3,1,2,2,0,54,0,1,55,1,1,100.0,Boric
2021-12-05 05:24:46.923710,9051,2850,True,37,124,13,23,0,3,3,203,0,0,203,2,2,100.0,Kast
2021-12-05 05:24:46.923710,9052,2849,True,97,98,16,32,4,7,5,259,1,0,260,2,2,100.0,Kast
2021-12-05 05:24:46.923710,9054,2853,True,11,30,4,11,0,1,0,57,0,0,57,1,1,100.0,Kast
2021-12-05 05:24:46.923710,9058,2857,True,160,97,26,74,3,6,4,370,1,0,371,3,3,100.0,Boric
2021-12-05 05:24:46.923710,9059,2858,True,86,125,14,28,1,3,8,265,0,0,265,2,2,100.0,Kast
2021-12-05 05:24:46.923710,9060,2859,True,164,147,28,69,4,5,9,426,0,0,426,3,3,100.0,Boric
2021-12-05 05:24:46.923710,9061,2860,True,164,741,41,255,0,20,15,1236,1,1,1238,7,7,100.0,Kast
2021-12-05 05:24:46.923710,9062,2861,True,468,284,95,247,10,19,14,1137,0,2,1139,7,7,100.0,Boric
2021-12-05 05:24:46.923710,9063,2920,True,72,73,8,10,0,6,20,189,1,1,191,1,1,100.0,Kast
2021-12-05 05:24:46.923710,9064,2862,True,206,115,37,60,3,6,10,437,0,0,437,3,3,100.0,Boric
2021-12-05 05:24:46.923710,9065,2921,True,126,60,9,55,3,6,6,265,1,0,266,2,2,100.0,Boric
2021-12-05 05:24:46.923710,9066,2863,True,193,204,64,113,2,10,2,588,0,2,590,3,3,100.0,Kast
2021-12-05 05:24:46.923710,9073,2869,True,24,50,8,12,0,0,1,95,0,0,95,1,1,100.0,Kast
2021-12-05 05:24:46.923710,9075,2870,True,0,0,0,0,0,0,0,0,0,0,0,0,0,0.0,Boric
2021-12-05 05:24:46.923710,9076,2871,True,5,14,5,1,0,3,1,29,0,0,29,1,1,100.0,Kast
2021-12-05 05:24:46.923710,9085,2879,True,2,3,0,2,0,0,0,7,0,0,7,1,1,100.0,Kast
2021-12-05 05:24:46.923710,9092,2885,True,291,126,43,59,9,4,8,540,2,1,543,3,3,100.0,Boric
2021-12-05 05:24:46.923710,9093,2886,True,23,13,6,5,1,2,1,51,1,0,52,1,1,100.0,Boric
2021-12-05 05:24:46.923710,9098,2890,True,67,101,9,39,0,4,6,226,2,0,228,1,1,100.0,Kast
2021-12-05 05:24:46.923710,9099,2891,True,43,126,10,24,0,3,2,208,0,0,208,1,1,100.0,Kast
2021-12-05 05:24:46.923710,9100,2892,True,114,320,31,104,3,9,17,598,2,1,601,3,3,100.0,Kast
2021-12-05 05:24:46.923710,9101,2893,True,4,17,2,1,1,3,0,28,0,0,28,1,1,100.0,Kast
2021-12-05 05:24:46.923710,9107,2898,True,24,50,7,17,1,2,3,104,0,0,104,1,1,100.0,Kast
2021-12-05 05:24:46.923710,9118,2911,True,133,40,21,28,8,11,4,245,2,1,248,1,1,100.0,Boric
2021-12-05 05:24:46.923710,9119,2913,True,52,119,27,16,6,1,0,221,0,0,221,2,2,100.0,Kast
2021-12-05 05:24:46.923710,9120,2912,True,22,61,11,10,1,3,1,109,0,0,109,1,1,100.0,Kast
2021-12-05 05:24:46.923710,9106,2844,True,38,4,5,4,1,0,2,54,1,0,55,1,1,100.0,Boric
2021-12-05 05:24:46.923710,9089,2852,True,1,10,1,5,0,0,0,17,0,0,17,1,1,100.0,Kast
2021-12-05 05:24:46.923710,9055,2854,True,16,15,0,12,0,0,1,44,0,1,45,1,1,100.0,Boric
2021-12-05 05:24:46.923710,9068,2865,True,1,4,1,2,1,0,1,10,0,0,10,1,1,100.0,Kast
2021-12-05 05:24:46.923710,9078,2873,True,4,3,3,0,0,1,0,11,0,1,12,1,1,100.0,Boric
2021-12-05 05:24:46.923710,9079,2874,True,2,2,0,2,0,0,0,6,0,0,6,1,1,100.0,Boric
2021-12-05 05:24:46.923710,9082,2876,True,15,40,11,18,0,0,0,84,1,0,85,1,1,100.0,Kast
2021-12-05 05:24:46.923710,9086,2880,True,54,13,3,17,6,3,10,106,2,0,108,1,1,100.0,Boric
2021-12-05 05:24:46.923710,9087,2881,True,2,2,0,2,0,0,4,10,0,0,10,1,1,100.0,Parisi
2021-12-05 05:24:46.923710,9090,2883,True,5,7,2,2,0,2,0,18,0,0,18,1,1,100.0,Kast
2021-12-05 05:24:46.923710,9042,2902,True,14,4,6,4,0,0,1,29,0,0,29,1,1,100.0,Boric
2021-12-05 05:24:46.923710,9043,2900,True,3,5,3,0,1,0,1,13,0,0,13,1,1,100.0,Kast
2021-12-05 05:24:46.923710,9044,2901,True,15,17,0,8,0,2,0,42,0,0,42,1,1,100.0,Kast
2021-12-05 05:24:46.923710,9045,2899,True,15,31,3,29,0,2,1,81,0,0,81,1,1,100.0,Kast
2021-12-05 05:24:46.923710,9109,2904,True,16,17,3,18,0,0,1,55,2,0,57,1,1,100.0,Sichel
2021-12-05 05:24:46.923710,9115,2909,True,9,6,2,3,0,0,2,22,0,0,22,1,1,100.0,Boric
2021-12-05 05:24:46.923710,9121,2914,True,2,2,0,1,0,0,1,6,0,0,6,1,1,100.0,Boric
2021-12-05 05:24:46.923710,9001,2811,True,1036,81,69,113,33,24,25,1381,10,6,1397,6,6,100.0,Boric
2021-12-05 05:24:46.923710,9002,2812,True,269,89,19,35,10,6,17,445,0,2,447,3,3,100.0,Boric
2021-12-05 05:24:46.923710,9003,2813,True,271,106,23,40,10,10,13,473,3,1,477,3,3,100.0,Boric
2021-12-05 05:24:46.923710,9004,2814,True,291,68,23,64,9,7,10,472,5,0,477,3,3,100.0,Boric
2021-12-05 05:24:46.923710,9027,2831,True,134,36,20,18,3,5,9,225,3,0,228,1,1,100.0,Boric
2021-12-05 05:24:46.923710,9028,2832,True,475,45,43,59,26,20,9,677,0,2,679,3,3,100.0,Boric
2021-12-05 05:24:46.923710,9048,2846,True,12,13,3,7,0,1,0,36,0,0,36,1,1,100.0,Kast
2021-12-05 05:24:46.923710,9050,2848,True,144,19,11,28,1,6,8,217,1,0,218,1,1,100.0,Boric
2021-12-05 05:24:46.923710,9056,2855,True,1659,242,139,236,56,45,71,2448,15,6,2469,15,15,100.0,Boric
2021-12-05 05:24:46.923710,9057,2856,True,743,314,96,200,29,18,33,1433,7,5,1445,9,9,100.0,Boric
2021-12-05 05:24:46.923710,9108,2864,True,13,11,0,3,0,1,1,29,0,0,29,1,1,100.0,Boric
2021-12-05 05:24:46.923710,9069,2866,True,82,27,6,13,5,2,5,140,3,0,143,1,1,100.0,Boric
2021-12-05 05:24:46.923710,9070,2867,True,1013,97,82,108,41,26,26,1393,7,2,1402,9,9,100.0,Boric
2021-12-05 05:24:46.923710,9072,2868,True,18,12,4,0,0,3,1,38,0,0,38,1,1,100.0,Boric
2021-12-05 05:24:46.923710,9077,2872,True,52,15,4,2,0,1,2,76,1,0,77,1,1,100.0,Boric
2021-12-05 05:24:46.923710,9081,2875,True,158,23,16,22,4,5,11,239,2,0,241,1,1,100.0,Boric
2021-12-05 05:24:46.923710,9083,2878,True,155,72,15,31,7,4,6,290,1,0,291,2,2,100.0,Boric
2021-12-05 05:24:46.923710,9084,2877,True,99,73,20,39,10,2,10,253,5,0,258,2,2,100.0,Boric
2021-12-05 05:24:46.923710,9094,2887,True,119,17,8,6,3,7,7,167,1,0,168,1,1,100.0,Boric
2021-12-05 05:24:46.923710,9096,2889,True,376,74,55,94,11,15,17,642,4,2,648,3,3,100.0,Boric
2021-12-05 05:24:46.923710,9102,2894,True,23,11,3,11,3,0,5,56,0,0,56,1,1,100.0,Boric
2021-12-05 05:24:46.923710,9103,2895,True,144,17,5,36,4,3,3,212,1,0,213,1,1,100.0,Boric
2021-12-05 05:24:46.923710,9104,2896,True,711,230,130,251,18,8,22,1370,4,2,1376,7,7,100.0,Boric
2021-12-05 05:24:46.923710,9105,2897,True,42,15,6,7,1,1,3,75,1,0,76,1,1,100.0,Boric
2021-12-05 05:24:46.923710,9035,2903,True,8,2,0,1,0,0,2,13,2,0,15,1,1,100.0,Boric
2021-12-05 05:24:46.923710,9112,2906,True,883,46,59,31,71,44,32,1166,2,1,1169,6,6,100.0,Boric
2021-12-05 05:24:46.923710,9113,2907,True,295,15,17,11,7,25,17,387,5,2,394,3,3,100.0,Boric
2021-12-05 05:24:46.923710,9114,2908,True,379,104,34,63,17,8,22,627,2,1,630,4,4,100.0,Boric
2021-12-05 05:24:46.923710,9117,2910,True,6,2,2,3,0,0,0,13,0,0,13,1,1,100.0,Boric
2021-12-05 05:24:46.923710,9023,2828,True,87,28,6,7,4,5,4,141,1,2,144,1,1,100.0,Boric
2021-12-05 05:24:46.923710,9024,2829,True,646,104,60,97,12,36,33,988,6,2,996,5,5,100.0,Boric
2021-12-05 05:24:46.923710,9025,2917,True,138,49,13,27,6,9,15,257,1,2,260,1,1,100.0,Boric
2021-12-05 05:24:46.923710,9026,2830,True,622,247,54,139,28,36,60,1186,7,4,1197,8,8,100.0,Boric
2021-12-05 05:24:46.923710,9123,2923,True,253,51,6,34,8,27,63,442,4,1,447,3,3,100.0,Boric
2021-12-05 05:24:46.923710,9095,2888,True,164,23,17,19,3,9,22,257,1,1,259,2,2,100.0,Boric
2021-12-05 05:24:46.923710,7103,396,False,550,681,203,300,35,138,192,2099,13,5,2117,14,14,100.0,Kast
2021-12-05 05:24:46.923710,7103,397,False,1378,1244,393,716,51,165,176,4123,18,7,4148,22,22,100.0,Boric
2021-12-05 05:24:46.923710,7103,398,False,846,693,251,354,39,143,153,2479,19,9,2507,15,15,100.0,Boric
2021-12-05 05:24:46.923710,7103,404,False,621,811,255,373,24,124,119,2327,9,3,2339,17,17,100.0,Kast
2021-12-05 05:24:46.923710,7103,399,False,1432,1509,440,768,87,300,267,4803,29,12,4844,29,29,100.0,Kast
2021-12-05 05:24:46.923710,7103,400,False,1039,1135,413,545,39,228,201,3600,23,8,3631,24,24,100.0,Kast
2021-12-05 05:24:46.923710,7103,401,False,1192,1171,339,542,50,147,207,3648,13,7,3668,20,20,100.0,Boric
2021-12-05 05:24:46.923710,7103,402,False,768,765,249,424,54,136,130,2526,16,10,2552,15,15,100.0,Boric
2021-12-05 05:24:46.923710,7103,403,False,1030,974,347,427,43,181,171,3173,21,10,3204,20,20,100.0,Boric
2021-12-05 05:24:46.923710,7491,1490,False,501,517,237,131,29,93,393,1901,16,15,1932,14,14,100.0,Kast
2021-12-05 05:24:46.923710,7491,1488,False,458,446,346,128,28,127,306,1839,19,25,1883,15,15,100.0,Boric
2021-12-05 05:24:46.923710,7491,2925,False,451,495,354,191,25,132,282,1930,25,15,1970,15,15,100.0,Kast
2021-12-05 05:24:46.923710,7491,1489,False,519,512,228,160,28,113,429,1989,34,9,2032,14,14,100.0,Boric
2021-12-05 05:24:46.923710,7140,1694,False,1063,695,266,390,69,236,165,2884,16,12,2912,18,18,100.0,Boric
2021-12-05 05:24:46.923710,7140,1688,False,734,640,240,373,39,186,103,2315,30,8,2353,20,20,100.0,Boric
2021-12-05 05:24:46.923710,7140,1689,False,783,647,271,371,44,226,111,2453,15,4,2472,20,20,100.0,Boric
2021-12-05 05:24:46.923710,7140,1692,False,842,635,289,402,46,230,140,2584,18,7,2609,20,20,100.0,Boric
2021-12-05 05:24:46.923710,7140,1693,False,976,697,302,356,54,281,172,2838,17,5,2860,20,20,100.0,Boric
2021-12-05 05:24:46.923710,7140,1695,False,810,658,279,307,44,212,153,2463,18,4,2485,18,18,100.0,Boric
2021-12-05 05:24:46.923710,7140,1696,False,869,702,266,312,48,238,158,2593,20,7,2620,18,18,100.0,Boric
2021-12-05 05:24:46.923710,7140,1697,False,1008,368,119,177,74,188,228,2162,20,3,2185,15,15,100.0,Boric
2021-12-05 05:24:46.923710,7140,1698,False,630,449,141,225,49,148,131,1773,25,3,1801,15,15,100.0,Boric
2021-12-05 05:24:46.923710,7140,1690,False,794,443,131,239,48,164,208,2027,10,9,2046,13,13,100.0,Boric
2021-12-05 05:24:46.923710,7140,1686,False,776,650,310,307,46,164,120,2373,23,11,2407,22,22,100.0,Boric
2021-12-05 05:24:46.923710,7140,1687,False,965,782,378,359,52,266,157,2959,17,7,2983,22,22,100.0,Boric
2021-12-05 05:24:46.923710,7140,1691,False,1040,746,236,308,79,224,192,2825,23,9,2857,16,16,100.0,Boric
2021-12-05 05:24:46.923710,7610,1424,False,506,675,206,198,42,168,638,2433,21,17,2471,18,18,100.0,Kast
2021-12-05 05:24:46.923710,7610,1425,False,586,1088,418,223,58,325,923,3621,34,33,3688,27,27,100.0,Kast
2021-12-05 05:24:46.923710,7610,1426,False,875,1106,347,302,74,295,899,3898,39,22,3959,27,27,100.0,Kast
2021-12-05 05:24:46.923710,7122,505,False,770,846,234,396,30,140,144,2560,6,4,2570,11,11,100.0,Kast
2021-12-05 05:24:46.923710,7122,504,False,630,1041,293,460,29,158,221,2832,21,8,2861,16,16,100.0,Kast
2021-12-05 05:24:46.923710,7122,2924,False,578,990,290,496,31,174,203,2762,16,8,2786,16,16,100.0,Kast
2021-12-05 05:24:46.923710,7218,2423,False,636,467,520,320,31,151,359,2484,19,16,2519,21,21,100.0,Boric
2021-12-05 05:24:46.923710,7079,280,False,53,158,63,31,5,48,87,445,4,0,449,4,4,100.0,Kast
2021-12-05 05:24:46.923710,7363,1013,False,219,356,216,82,25,74,149,1121,40,41,1202,11,11,100.0,Kast
2021-12-05 05:24:46.923710,7042,165,False,99,83,252,34,6,25,114,613,7,7,627,5,5,100.0,Provoste
2021-12-05 05:24:46.923710,7589,39,False,342,678,286,198,28,297,1018,2847,33,4,2884,18,18,100.0,Parisi
2021-12-05 05:24:46.923710,7589,40,False,284,534,122,87,15,128,1321,2491,12,4,2507,20,20,100.0,Parisi
2021-12-05 05:24:46.923710,7589,37,False,330,641,273,106,31,156,844,2381,16,9,2406,16,16,100.0,Parisi
2021-12-05 05:24:46.923710,7589,42,False,458,712,217,132,51,172,1280,3022,23,9,3054,25,25,100.0,Parisi
2021-12-05 05:24:46.923710,7589,41,False,372,597,186,100,28,140,1162,2585,24,5,2614,20,20,100.0,Parisi
2021-12-05 05:24:46.923710,7589,43,False,529,857,267,170,52,232,1412,3519,19,11,3549,25,25,100.0,Parisi
2021-12-05 05:24:46.923710,7589,35,False,366,682,413,219,19,296,982,2977,18,14,3009,19,19,100.0,Parisi
2021-12-05 05:24:46.923710,7589,38,False,193,540,114,95,20,129,1144,2235,12,4,2251,20,20,100.0,Parisi
2021-12-05 05:24:46.923710,7589,36,False,309,619,334,105,19,162,721,2269,16,10,2295,16,16,100.0,Parisi
2021-12-05 05:24:46.923710,7764,2568,False,459,653,271,231,34,166,269,2083,21,11,2115,13,13,100.0,Kast
2021-12-05 05:24:46.923710,7764,2569,False,519,494,162,227,28,129,319,1878,13,5,1896,13,13,100.0,Boric
2021-12-05 05:24:46.923710,7467,1372,False,887,941,405,341,47,197,580,3398,20,26,3444,25,25,100.0,Kast
2021-12-05 05:24:46.923710,7467,1373,False,577,711,424,330,35,173,254,2504,24,30,2558,20,20,100.0,Kast
2021-12-05 05:24:46.923710,7467,1374,False,376,464,267,191,20,94,200,1612,7,13,1632,12,12,100.0,Kast
2021-12-05 05:24:46.923710,7467,1375,False,318,253,67,75,25,33,241,1012,6,0,1018,10,10,100.0,Boric
2021-12-05 05:24:46.923710,7467,1376,False,608,724,447,287,35,163,333,2597,22,21,2640,20,20,100.0,Kast
2021-12-05 05:24:46.923710,7467,1377,False,662,818,422,370,50,171,328,2821,26,12,2859,20,20,100.0,Kast
2021-12-05 05:24:46.923710,7050,205,False,520,324,333,174,23,220,555,2149,31,15,2195,16,16,100.0,Parisi
2021-12-05 05:24:46.923710,7050,204,False,661,337,464,133,41,188,617,2441,30,34,2505,19,19,100.0,Boric
2021-12-05 05:24:46.923710,7335,856,False,299,389,158,190,8,129,182,1355,11,3,1369,10,10,100.0,Kast
2021-12-05 05:24:46.923710,7335,857,False,624,781,355,369,42,192,346,2709,26,4,2739,17,17,100.0,Kast
2021-12-05 05:24:46.923710,7335,858,False,908,910,494,394,54,217,448,3425,32,25,3482,23,23,100.0,Kast
2021-12-05 05:24:46.923710,7335,859,False,602,963,410,410,34,275,471,3165,29,11,3205,22,22,100.0,Kast
2021-12-05 05:24:46.923710,7335,860,False,751,895,349,330,49,186,397,2957,16,11,2984,20,20,100.0,Kast
2021-12-05 05:24:46.923710,7335,861,False,493,697,334,315,38,147,352,2376,28,12,2416,16,16,100.0,Kast
2021-12-05 05:24:46.923710,7335,862,False,344,413,218,202,19,125,182,1503,15,4,1522,10,10,100.0,Kast
2021-12-05 05:24:46.923710,7335,863,False,398,445,203,184,29,90,199,1548,22,7,1577,10,10,100.0,Kast
2021-12-05 05:24:46.923710,7335,864,False,679,766,284,365,31,177,328,2630,9,3,2642,15,15,100.0,Kast
2021-12-05 05:24:46.923710,7335,865,False,412,539,244,255,21,151,240,1862,26,2,1890,14,14,100.0,Kast
2021-12-05 05:24:46.923710,7335,866,False,719,851,292,313,42,137,363,2717,12,4,2733,17,17,100.0,Kast
2021-12-05 05:24:46.923710,7382,1102,False,233,1015,257,252,12,113,225,2107,19,6,2132,16,16,100.0,Kast
2021-12-05 05:24:46.923710,7382,1103,False,249,1127,276,250,21,116,301,2340,19,15,2374,16,16,100.0,Kast
2021-12-05 05:24:46.923710,7382,1104,False,335,1011,219,223,19,102,388,2297,21,12,2330,15,15,100.0,Kast
2021-12-05 05:24:46.923710,7382,1105,False,385,1254,213,189,20,105,402,2568,15,12,2595,16,16,100.0,Kast
2021-12-05 05:24:46.923710,7382,1106,False,274,1135,249,217,13,119,339,2346,24,14,2384,15,15,100.0,Kast
2021-12-05 05:24:46.923710,7382,1108,False,252,939,259,202,17,89,212,1970,21,16,2007,15,15,100.0,Kast
2021-12-05 05:24:46.923710,7382,1109,False,274,1088,285,217,20,78,332,2294,22,18,2334,15,15,100.0,Kast
2021-12-05 05:24:46.923710,7382,1107,False,364,904,127,172,15,60,438,2080,13,6,2099,14,14,100.0,Kast
2021-12-05 05:24:46.923710,7382,1110,False,376,1311,253,266,13,125,375,2719,18,8,2745,15,15,100.0,Kast
2021-12-05 05:24:46.923710,7514,1557,False,4,34,1,2,0,2,4,47,0,0,47,1,1,100.0,Kast
2021-12-05 05:24:46.923710,7670,1085,False,93,652,147,79,12,56,194,1233,10,9,1252,9,9,100.0,Kast
2021-12-05 05:24:46.923710,7583,2654,False,65,118,79,34,9,32,74,411,7,7,425,3,3,100.0,Kast
2021-12-05 05:24:46.923710,7023,84,False,379,399,64,80,27,109,1444,2502,11,6,2519,20,20,100.0,Parisi
2021-12-05 05:24:46.923710,7023,85,False,682,410,108,157,47,164,975,2543,19,6,2568,20,20,100.0,Parisi
2021-12-05 05:24:46.923710,7023,86,False,573,427,90,134,37,168,1618,3047,12,8,3067,22,22,100.0,Parisi
2021-12-05 05:24:46.923710,7023,87,False,590,573,282,223,42,349,1120,3179,32,10,3221,20,20,100.0,Parisi
2021-12-05 05:24:46.923710,7023,88,False,689,692,260,186,60,207,1105,3199,27,4,3230,20,20,100.0,Parisi
2021-12-05 05:24:46.923710,7023,89,False,352,421,208,134,30,189,514,1848,26,11,1885,15,15,100.0,Parisi
2021-12-05 05:24:46.923710,7023,90,False,535,476,123,165,42,161,816,2318,18,8,2344,18,18,100.0,Parisi
2021-12-05 05:24:46.923710,7023,91,False,634,641,317,238,34,343,1056,3263,25,12,3300,22,22,100.0,Parisi
2021-12-05 05:24:46.923710,7023,92,False,407,281,76,100,26,130,909,1929,29,2,1960,15,15,100.0,Parisi
2021-12-05 05:24:46.923710,7023,93,False,623,569,294,153,33,245,1188,3105,22,5,3132,20,20,100.0,Parisi
2021-12-05 05:24:46.923710,7023,94,False,535,555,277,206,31,305,1019,2928,21,9,2958,22,22,100.0,Parisi
2021-12-05 05:24:46.923710,7023,95,False,675,539,361,198,43,272,958,3046,16,15,3077,22,22,100.0,Parisi
2021-12-05 05:24:46.923710,7023,97,False,582,486,262,164,30,234,806,2564,22,5,2591,15,15,100.0,Parisi
2021-12-05 05:24:46.923710,7023,96,False,520,591,274,187,29,245,815,2661,19,9,2689,20,20,100.0,Parisi
2021-12-05 05:24:46.923710,7023,98,False,589,514,323,168,30,210,1001,2835,25,14,2874,20,20,100.0,Parisi
2021-12-05 05:24:46.923710,7023,99,False,608,483,154,148,44,145,871,2453,21,8,2482,23,23,100.0,Parisi
2021-12-05 05:24:46.923710,7023,100,False,736,531,204,211,48,214,1089,3033,22,9,3064,23,23,100.0,Parisi
2021-12-05 05:24:46.923710,7023,101,False,714,381,109,137,59,181,1563,3144,18,4,3166,23,23,100.0,Parisi
2021-12-05 05:24:46.923710,7023,102,False,575,585,276,221,28,302,953,2940,21,6,2967,22,22,100.0,Parisi
2021-12-05 05:24:46.923710,7023,103,False,668,605,365,208,43,282,1110,3281,43,14,3338,22,22,100.0,Parisi
2021-12-05 05:24:46.923710,7023,104,False,767,645,138,188,49,195,940,2922,21,16,2959,22,22,100.0,Parisi
2021-12-05 05:24:46.923710,7025,124,False,637,676,254,263,21,180,666,2697,23,8,2728,20,20,100.0,Kast
2021-12-05 05:24:46.923710,7025,105,False,746,625,121,214,47,146,1123,3022,27,11,3060,23,23,100.0,Parisi
2021-12-05 05:24:46.923710,7025,106,False,729,757,259,317,37,268,823,3190,26,7,3223,20,20,100.0,Parisi
2021-12-05 05:24:46.923710,7025,107,False,841,811,192,304,33,156,633,2970,16,9,2995,20,20,100.0,Boric
2021-12-05 05:24:46.923710,7025,108,False,712,758,257,301,31,230,732,3021,25,9,3055,20,20,100.0,Kast
2021-12-05 05:24:46.923710,7025,109,False,623,679,217,211,23,140,500,2393,19,4,2416,16,16,100.0,Kast
2021-12-05 05:24:46.923710,7025,110,False,696,761,353,322,44,236,685,3097,25,7,3129,20,20,100.0,Kast
2021-12-05 05:24:46.923710,7025,111,False,808,758,234,273,49,184,742,3048,20,12,3080,20,20,100.0,Boric
2021-12-05 05:24:46.923710,7025,112,False,724,771,330,273,36,189,702,3025,8,16,3049,20,20,100.0,Kast
2021-12-05 05:24:46.923710,7025,113,False,625,718,247,295,31,170,543,2629,14,7,2650,16,16,100.0,Kast
2021-12-05 05:24:46.923710,7025,114,False,635,836,339,311,33,219,697,3070,29,10,3109,20,20,100.0,Kast
2021-12-05 05:24:46.923710,7025,115,False,641,756,295,341,39,212,547,2831,12,9,2852,20,20,100.0,Kast
2021-12-05 05:24:46.923710,7025,116,False,476,753,247,254,25,164,408,2327,28,8,2363,20,20,100.0,Kast
2021-12-05 05:24:46.923710,7025,125,False,643,827,301,333,32,254,607,2997,32,13,3042,23,23,100.0,Kast
2021-12-05 05:24:46.923710,7025,117,False,1099,1245,327,410,65,220,752,4118,25,12,4155,24,24,100.0,Kast
2021-12-05 05:24:46.923710,7025,118,False,559,763,294,336,28,160,372,2512,39,14,2565,21,21,100.0,Kast
2021-12-05 05:24:46.923710,7025,119,False,791,729,268,258,43,255,746,3090,26,8,3124,21,21,100.0,Boric
2021-12-05 05:24:46.923710,7025,120,False,814,621,188,220,60,179,822,2904,25,13,2942,23,23,100.0,Parisi
2021-12-05 05:24:46.923710,7025,121,False,758,730,240,275,40,213,867,3123,30,10,3163,20,20,100.0,Parisi
2021-12-05 05:24:46.923710,7025,122,False,1023,853,355,408,48,223,646,3556,15,8,3579,20,20,100.0,Boric
2021-12-05 05:24:46.923710,7025,123,False,1103,1011,253,448,55,210,771,3851,25,7,3883,21,21,100.0,Boric
2021-12-05 05:24:46.923710,7360,1008,False,245,547,332,210,17,91,400,1842,27,11,1880,15,15,100.0,Kast
2021-12-05 05:24:46.923710,7761,1473,False,23,17,30,15,0,11,22,118,4,1,123,2,2,100.0,Provoste
2021-12-05 05:24:46.923710,7202,2257,False,557,1780,344,1161,26,85,53,4006,20,8,4034,20,20,100.0,Kast
2021-12-05 05:24:46.923710,7202,2232,False,472,2047,289,1348,14,47,35,4252,15,9,4276,20,20,100.0,Kast
2021-12-05 05:24:46.923710,7202,2233,False,676,2120,331,1637,14,47,48,4873,15,4,4892,20,20,100.0,Kast
2021-12-05 05:24:46.923710,7202,2234,False,340,1369,222,936,5,41,24,2937,14,8,2959,15,15,100.0,Kast
2021-12-05 05:24:46.923710,7202,2235,False,546,1589,294,1038,17,99,62,3645,14,4,3663,18,18,100.0,Kast
2021-12-05 05:24:46.923710,7202,2236,False,658,1526,287,1131,22,85,70,3779,11,6,3796,18,18,100.0,Kast
2021-12-05 05:24:46.923710,7202,2237,False,581,1850,272,1335,16,39,51,4144,15,13,4172,18,18,100.0,Kast
2021-12-05 05:24:46.923710,7202,2253,False,577,1906,306,1342,11,54,33,4229,17,5,4251,18,18,100.0,Kast
2021-12-05 05:24:46.923710,7202,2238,False,624,2202,314,1777,13,65,37,5032,21,5,5058,20,20,100.0,Kast
2021-12-05 05:24:46.923710,7202,2256,False,846,2262,360,1839,18,84,58,5467,22,5,5494,20,20,100.0,Kast
2021-12-05 05:24:46.923710,7202,2239,False,390,1407,216,964,10,53,41,3081,17,7,3105,17,17,100.0,Kast
2021-12-05 05:24:46.923710,7202,2240,False,605,1648,251,1247,28,58,51,3888,18,18,3924,17,17,100.0,Kast
2021-12-05 05:24:46.923710,7202,2241,False,581,1740,306,1269,14,63,39,4012,14,14,4040,20,20,100.0,Kast
2021-12-05 05:24:46.923710,7202,2254,False,333,1587,262,982,13,50,20,3247,13,5,3265,18,18,100.0,Kast
2021-12-05 05:24:46.923710,7202,2255,False,439,1569,354,1034,15,75,35,3521,13,3,3537,18,18,100.0,Kast
2021-12-05 05:24:46.923710,7202,2242,False,627,1986,318,1392,16,64,44,4447,17,7,4471,18,18,100.0,Kast
2021-12-05 05:24:46.923710,7202,2243,False,542,1764,346,1155,15,121,63,4006,19,11,4036,19,19,100.0,Kast
2021-12-05 05:24:46.923710,7202,2244,False,581,1820,356,1116,22,85,58,4038,17,7,4062,19,19,100.0,Kast
2021-12-05 05:24:46.923710,7202,2249,False,715,1746,298,1409,22,108,105,4403,22,12,4437,22,22,100.0,Kast
2021-12-05 05:24:46.923710,7202,2250,False,760,1789,314,1361,28,131,97,4480,28,14,4522,22,22,100.0,Kast
2021-12-05 05:24:46.923710,7202,2251,False,344,1365,267,891,12,40,26,2945,15,11,2971,18,18,100.0,Kast
2021-12-05 05:24:46.923710,7202,2252,False,495,1626,330,1032,9,72,45,3609,24,7,3640,18,18,100.0,Kast
2021-12-05 05:24:46.923710,7202,2245,False,604,1898,353,1252,20,56,50,4233,16,6,4255,19,19,100.0,Kast
2021-12-05 05:24:46.923710,7202,2246,False,539,2084,300,1349,12,48,44,4376,25,7,4408,19,19,100.0,Kast
2021-12-05 05:24:46.923710,7202,2247,False,504,1535,236,1032,22,104,69,3502,24,5,3531,17,17,100.0,Kast
2021-12-05 05:24:46.923710,7202,2248,False,515,1469,205,981,11,91,98,3370,21,7,3398,17,17,100.0,Kast
2021-12-05 05:24:46.923710,7376,1039,False,205,296,29,53,12,55,366,1016,5,6,1027,10,10,100.0,Parisi
2021-12-05 05:24:46.923710,7376,1040,False,226,447,175,140,8,87,256,1339,18,7,1364,13,13,100.0,Kast
2021-12-05 05:24:46.923710,7376,1041,False,209,410,149,140,12,73,305,1298,10,3,1311,11,11,100.0,Kast
2021-12-05 05:24:46.923710,7376,1042,False,289,566,223,132,20,84,395,1709,21,12,1742,15,15,100.0,Kast
2021-12-05 05:24:46.923710,7376,1043,False,334,735,276,191,14,153,445,2148,22,9,2179,19,19,100.0,Kast
2021-12-05 05:24:46.923710,7376,1044,False,273,557,143,115,13,79,423,1603,11,8,1622,13,13,100.0,Kast
2021-12-05 05:24:46.923710,7001,2674,False,147,187,63,38,8,40,183,666,5,0,671,6,6,100.0,Kast
2021-12-05 05:24:46.923710,7001,2675,False,357,792,226,222,19,139,421,2176,26,7,2209,15,15,100.0,Kast
2021-12-05 05:24:46.923710,7001,2676,False,251,466,152,144,15,75,288,1391,12,2,1405,10,10,100.0,Kast
2021-12-05 05:24:46.923710,7001,2677,False,429,491,197,148,22,88,446,1821,11,8,1840,13,13,100.0,Kast
2021-12-05 05:24:46.923710,7001,2678,False,279,578,134,122,33,73,470,1689,16,4,1709,16,16,100.0,Kast
2021-12-05 05:24:46.923710,7001,2679,False,156,274,69,49,11,46,277,882,8,5,895,8,8,100.0,Parisi
2021-12-05 05:24:46.923710,7001,2695,False,184,287,78,67,17,42,254,929,8,2,939,8,8,100.0,Kast
2021-12-05 05:24:46.923710,7001,2680,False,282,402,97,87,18,60,395,1341,10,3,1354,15,15,100.0,Kast
2021-12-05 05:24:46.923710,7001,2682,False,728,1041,442,265,52,205,952,3685,35,14,3734,25,25,100.0,Kast
2021-12-05 05:24:46.923710,7001,2683,False,406,691,225,180,25,126,542,2195,11,7,2213,15,15,100.0,Kast
2021-12-05 05:24:46.923710,7001,2684,False,292,470,121,104,8,65,380,1440,11,3,1454,11,11,100.0,Kast
2021-12-05 05:24:46.923710,7001,2685,False,484,758,229,217,32,142,637,2499,25,4,2528,15,15,100.0,Kast
2021-12-05 05:24:46.923710,7001,2686,False,274,532,178,109,19,57,298,1467,13,6,1486,11,11,100.0,Kast
2021-12-05 05:24:46.923710,7001,2687,False,317,551,202,153,21,86,427,1757,10,9,1776,12,12,100.0,Kast
2021-12-05 05:24:46.923710,7001,2688,False,166,298,72,61,10,35,217,859,5,1,865,6,6,100.0,Kast
2021-12-05 05:24:46.923710,7001,2689,False,150,214,54,46,12,46,219,741,0,3,744,6,6,100.0,Parisi
2021-12-05 05:24:46.923710,7001,2690,False,196,312,119,77,16,66,269,1055,7,6,1068,8,8,100.0,Kast
2021-12-05 05:24:46.923710,7001,2691,False,157,284,86,94,8,55,189,873,5,4,882,6,6,100.0,Kast
2021-12-05 05:24:46.923710,7001,2692,False,906,1339,425,399,45,277,1229,4620,34,7,4661,30,30,100.0,Kast
2021-12-05 05:24:46.923710,7001,2693,False,375,717,192,168,27,113,502,2094,15,6,2115,15,15,100.0,Kast
2021-12-05 05:24:46.923710,7001,2694,False,285,469,172,173,25,96,362,1582,10,7,1599,10,10,100.0,Kast
2021-12-05 05:24:46.923710,7001,2696,False,304,439,161,132,20,75,353,1484,10,3,1497,10,10,100.0,Kast
2021-12-05 05:24:46.923710,7660,2704,False,304,531,183,135,17,107,623,1900,15,4,1919,12,12,100.0,Parisi
2021-12-05 05:24:46.923710,7660,2705,False,394,665,189,158,18,125,724,2273,17,7,2297,15,15,100.0,Parisi
2021-12-05 05:24:46.923710,7660,2706,False,359,663,203,168,29,132,804,2358,17,4,2379,15,15,100.0,Parisi
2021-12-05 05:24:46.923710,7660,2714,False,261,445,173,110,12,89,481,1571,11,10,1592,10,10,100.0,Parisi
2021-12-05 05:24:46.923710,7660,2707,False,619,1063,302,244,29,204,1398,3859,26,11,3896,25,25,100.0,Parisi
2021-12-05 05:24:46.923710,7660,2708,False,250,446,152,107,16,92,521,1584,11,6,1601,10,10,100.0,Parisi
2021-12-05 05:24:46.923710,7660,2709,False,215,355,116,81,18,78,445,1308,8,2,1318,8,8,100.0,Parisi
2021-12-05 05:24:46.923710,7660,2710,False,271,452,143,110,16,92,538,1622,25,5,1652,10,10,100.0,Parisi
2021-12-05 05:24:46.923710,7660,2711,False,201,354,112,81,16,65,405,1234,10,3,1247,8,8,100.0,Parisi
2021-12-05 05:24:46.923710,7660,2712,False,302,502,88,100,23,47,475,1537,11,6,1554,8,8,100.0,Kast
2021-12-05 05:24:46.923710,7660,2713,False,331,459,121,100,23,67,465,1566,12,5,1583,10,10,100.0,Parisi
2021-12-05 05:24:46.923710,7699,825,False,165,468,205,150,10,54,164,1216,14,15,1245,10,10,100.0,Kast
2021-12-05 05:24:46.923710,7481,1397,False,74,156,105,41,6,22,32,436,0,11,447,4,4,100.0,Kast
2021-12-05 05:24:46.923710,7611,1427,False,175,156,188,51,16,51,113,750,8,5,763,5,5,100.0,Provoste
2021-12-05 05:24:46.923710,7572,1505,False,39,83,29,28,2,11,12,204,4,3,211,2,2,100.0,Kast
2021-12-05 05:24:46.923710,7657,2536,False,494,207,160,137,37,268,288,1591,10,9,1610,11,11,100.0,Boric
2021-12-05 05:24:46.923710,7657,2537,False,594,186,114,113,51,222,280,1560,24,6,1590,13,13,100.0,Boric
2021-12-05 05:24:46.923710,7657,2538,False,962,340,219,207,90,408,542,2768,46,22,2836,22,22,100.0,Boric
2021-12-05 05:24:46.923710,7657,2539,False,497,361,311,229,51,466,282,2197,23,15,2235,16,16,100.0,Boric
2021-12-05 05:24:46.923710,7657,2540,False,567,292,115,163,51,354,442,1984,16,1,2001,16,16,100.0,Boric
2021-12-05 05:24:46.923710,7488,1484,False,55,82,19,24,3,9,16,208,3,3,214,2,2,100.0,Kast
2021-12-05 05:24:46.923710,7099,367,False,700,468,270,195,53,237,185,2108,24,15,2147,15,15,100.0,Boric
2021-12-05 05:24:46.923710,7099,368,False,1109,698,219,216,84,165,233,2724,12,5,2741,16,16,100.0,Boric
2021-12-05 05:24:46.923710,7099,369,False,796,343,175,187,33,153,141,1828,13,4,1845,10,10,100.0,Boric
2021-12-05 05:24:46.923710,7099,370,False,728,407,207,220,47,197,265,2071,14,2,2087,14,14,100.0,Boric
2021-12-05 05:24:46.923710,7099,382,False,819,426,242,156,58,180,206,2087,17,13,2117,14,14,100.0,Boric
2021-12-05 05:24:46.923710,7099,371,False,754,466,234,250,50,213,223,2190,19,11,2220,15,15,100.0,Boric
2021-12-05 05:24:46.923710,7099,372,False,813,465,197,151,53,175,211,2065,15,6,2086,14,14,100.0,Boric
2021-12-05 05:24:46.923710,7099,373,False,759,433,266,180,53,191,237,2119,25,13,2157,15,15,100.0,Boric
2021-12-05 05:24:46.923710,7099,374,False,867,421,267,173,56,225,240,2249,21,8,2278,15,15,100.0,Boric
2021-12-05 05:24:46.923710,7099,375,False,731,406,231,208,48,205,199,2028,19,5,2052,14,14,100.0,Boric
2021-12-05 05:24:46.923710,7099,376,False,403,322,146,152,20,166,146,1355,12,3,1370,10,10,100.0,Boric
2021-12-05 05:24:46.923710,7099,377,False,975,470,221,260,46,225,205,2402,15,6,2423,14,14,100.0,Boric
2021-12-05 05:24:46.923710,7099,378,False,425,326,134,176,29,155,170,1415,12,2,1429,10,10,100.0,Boric
2021-12-05 05:24:46.923710,7099,379,False,571,465,225,222,34,150,122,1789,17,10,1816,15,15,100.0,Boric
2021-12-05 05:24:46.923710,7099,380,False,1292,719,307,371,86,346,267,3388,24,12,3424,22,22,100.0,Boric
2021-12-05 05:24:46.923710,7099,383,False,393,293,166,120,26,125,98,1221,17,5,1243,11,11,100.0,Boric
2021-12-05 05:24:46.923710,7099,381,False,811,456,257,174,55,186,205,2144,21,12,2177,17,17,100.0,Boric
2021-12-05 05:24:46.923710,7054,222,False,164,143,295,96,10,58,143,909,10,15,934,8,8,100.0,Provoste
2021-12-05 05:24:46.923710,7594,1272,False,78,318,143,120,3,36,66,764,8,13,785,5,5,100.0,Kast
2021-12-05 05:24:46.923710,7662,2541,False,709,523,222,276,56,196,382,2364,14,13,2391,15,15,100.0,Boric
2021-12-05 05:24:46.923710,7662,2542,False,641,627,280,279,45,351,613,2836,28,10,2874,19,19,100.0,Boric
2021-12-05 05:24:46.923710,7005,2699,False,51,148,98,24,4,19,160,504,5,9,518,3,3,100.0,Parisi
2021-12-05 05:24:46.923710,7185,2054,False,1422,688,236,488,85,362,411,3692,14,5,3711,23,23,100.0,Boric
2021-12-05 05:24:46.923710,7185,2073,False,1046,732,426,511,54,255,138,3162,25,13,3200,18,18,100.0,Boric
2021-12-05 05:24:46.923710,7185,2055,False,894,661,378,494,43,267,124,2861,15,15,2891,18,18,100.0,Boric
2021-12-05 05:24:46.923710,7185,2056,False,1012,729,349,511,44,276,146,3067,25,7,3099,18,18,100.0,Boric
2021-12-05 05:24:46.923710,7185,2060,False,2217,997,390,827,98,335,350,5214,21,13,5248,24,24,100.0,Boric
2021-12-05 05:24:46.923710,7185,2071,False,819,635,363,424,36,200,107,2584,29,8,2621,18,18,100.0,Boric
2021-12-05 05:24:46.923710,7185,2062,False,1363,752,433,619,62,293,226,3748,12,12,3772,23,23,100.0,Boric
2021-12-05 05:24:46.923710,7185,2063,False,1711,858,436,673,79,323,198,4278,27,6,4311,23,23,100.0,Boric
2021-12-05 05:24:46.923710,7185,2074,False,810,728,335,477,46,239,125,2760,19,10,2789,18,18,100.0,Boric
2021-12-05 05:24:46.923710,7185,2064,False,1042,676,351,542,45,293,170,3119,21,9,3149,18,18,100.0,Boric
2021-12-05 05:24:46.923710,7185,2065,False,987,686,329,445,56,320,169,2992,17,4,3013,18,18,100.0,Boric
2021-12-05 05:24:46.923710,7185,2066,False,1808,1034,501,566,101,313,235,4558,23,8,4589,22,22,100.0,Boric
2021-12-05 05:24:46.923710,7185,2067,False,1423,721,300,483,81,209,221,3438,23,10,3471,22,22,100.0,Boric
2021-12-05 05:24:46.923710,7185,2068,False,1518,557,246,485,86,309,434,3635,27,6,3668,22,22,100.0,Boric
2021-12-05 05:24:46.923710,7185,2069,False,1829,546,216,435,96,263,375,3760,35,9,3804,22,22,100.0,Boric
2021-12-05 05:24:46.923710,7185,2057,False,957,683,387,410,60,283,138,2918,15,6,2939,17,17,100.0,Boric
2021-12-05 05:24:46.923710,7185,2058,False,967,648,375,434,52,232,160,2868,21,8,2897,17,17,100.0,Boric
2021-12-05 05:24:46.923710,7185,2059,False,1073,704,356,395,38,279,177,3022,16,6,3044,17,17,100.0,Boric
2021-12-05 05:24:46.923710,7185,2072,False,910,650,417,415,42,252,116,2802,17,5,2824,18,18,100.0,Boric
2021-12-05 05:24:46.923710,7185,2070,False,1660,739,332,587,98,259,278,3953,34,18,4005,21,21,100.0,Boric
2021-12-05 05:24:46.923710,7185,2061,False,1207,603,288,498,52,234,117,2999,21,6,3026,14,14,100.0,Boric
2021-12-05 05:24:46.923710,7704,676,False,143,85,76,48,3,36,41,432,2,4,438,2,2,100.0,Boric
2021-12-05 05:24:46.923710,7729,2808,False,91,247,79,127,3,32,50,629,9,7,645,4,4,100.0,Kast
2021-12-05 05:24:46.923710,7700,826,False,172,344,101,144,6,44,136,947,8,6,961,6,6,100.0,Kast
2021-12-05 05:24:46.923710,7214,2391,False,916,619,184,312,53,198,439,2721,10,4,2735,18,18,100.0,Boric
2021-12-05 05:24:46.923710,7214,2392,False,580,515,126,231,21,124,214,1811,14,4,1829,12,12,100.0,Boric
2021-12-05 05:24:46.923710,7214,2393,False,792,992,338,384,31,252,341,3130,30,13,3173,19,19,100.0,Kast
2021-12-05 05:24:46.923710,7214,2394,False,850,955,338,396,30,300,339,3208,23,9,3240,19,19,100.0,Kast
2021-12-05 05:24:46.923710,7214,2395,False,781,950,391,313,49,278,347,3109,20,15,3144,19,19,100.0,Kast
2021-12-05 05:24:46.923710,7214,2396,False,691,871,351,323,32,219,290,2777,33,13,2823,19,19,100.0,Kast
2021-12-05 05:24:46.923710,7214,2397,False,624,912,322,332,33,250,277,2750,19,6,2775,18,18,100.0,Kast
2021-12-05 05:24:46.923710,7214,2398,False,665,848,277,358,39,227,284,2698,26,9,2733,17,17,100.0,Kast
2021-12-05 05:24:46.923710,7214,2402,False,554,496,92,242,29,126,196,1735,9,3,1747,11,11,100.0,Boric
2021-12-05 05:24:46.923710,7214,2401,False,747,721,193,287,26,190,449,2613,18,5,2636,17,17,100.0,Boric
2021-12-05 05:24:46.923710,7214,2399,False,836,566,150,285,37,200,587,2661,8,3,2672,18,18,100.0,Boric
2021-12-05 05:24:46.923710,7214,2400,False,729,1007,283,333,29,236,350,2967,17,13,2997,17,17,100.0,Kast
2021-12-05 05:24:46.923710,7322,2778,False,282,627,236,252,23,87,208,1715,42,18,1775,14,14,100.0,Kast
2021-12-05 05:24:46.923710,7322,2779,False,390,877,468,350,25,127,282,2519,32,30,2581,21,21,100.0,Kast
2021-12-05 05:24:46.923710,7322,2780,False,480,1234,578,536,22,197,368,3415,39,18,3472,25,25,100.0,Kast
2021-12-05 05:24:46.923710,7315,2766,False,201,841,282,217,26,104,193,1864,18,23,1905,15,15,100.0,Kast
2021-12-05 05:24:46.923710,7074,266,False,913,548,557,235,40,260,457,3010,27,21,3058,20,20,100.0,Boric
2021-12-05 05:24:46.923710,7074,267,False,639,352,200,151,22,131,458,1953,14,7,1974,14,14,100.0,Boric
2021-12-05 05:24:46.923710,7074,268,False,770,527,501,277,39,289,393,2796,35,14,2845,19,19,100.0,Boric
2021-12-05 05:24:46.923710,7513,1556,False,189,421,74,63,10,28,82,867,6,5,878,6,6,100.0,Kast
2021-12-05 05:24:46.923710,7357,1001,False,159,426,163,108,10,77,390,1333,10,16,1359,9,9,100.0,Kast
2021-12-05 05:24:46.923710,7357,1002,False,236,522,145,117,17,79,447,1563,9,14,1586,11,11,100.0,Kast
2021-12-05 05:24:46.923710,7357,1003,False,265,832,305,216,18,151,610,2397,26,21,2444,17,17,100.0,Kast
2021-12-05 05:24:46.923710,7357,1004,False,301,890,339,269,28,155,687,2669,20,14,2703,20,20,100.0,Kast
2021-12-05 05:24:46.923710,7311,2760,False,120,332,127,125,10,59,107,880,10,9,899,9,9,100.0,Kast
2021-12-05 05:24:46.923710,7068,247,False,113,96,87,33,3,34,112,478,6,2,486,4,4,100.0,Boric
2021-12-05 05:24:46.923710,7628,1275,False,324,659,251,215,26,137,306,1918,29,10,1957,10,10,100.0,Kast
2021-12-05 05:24:46.923710,7019,61,False,512,716,315,257,29,295,1557,3681,41,7,3729,22,22,100.0,Parisi
2021-12-05 05:24:46.923710,7019,62,False,369,507,197,183,23,176,901,2356,25,6,2387,16,16,100.0,Parisi
2021-12-05 05:24:46.923710,7019,63,False,455,590,328,192,33,195,1179,2972,20,10,3002,20,20,100.0,Parisi
2021-12-05 05:24:46.923710,7019,64,False,427,610,267,191,23,232,1416,3166,29,11,3206,20,20,100.0,Parisi
2021-12-05 05:24:46.923710,7019,65,False,423,554,234,152,24,195,1399,2981,28,11,3020,20,20,100.0,Parisi
2021-12-05 05:24:46.923710,7019,66,False,288,378,109,114,23,114,750,1776,16,7,1799,16,16,100.0,Parisi
2021-12-05 05:24:46.923710,7019,67,False,482,537,155,151,48,156,1326,2855,41,9,2905,23,23,100.0,Parisi
2021-12-05 05:24:46.923710,7019,68,False,486,773,321,241,27,301,1250,3399,32,10,3441,22,22,100.0,Parisi
2021-12-05 05:24:46.923710,7019,69,False,541,667,289,181,30,245,1459,3412,24,8,3444,22,22,100.0,Parisi
2021-12-05 05:24:46.923710,7019,70,False,404,648,263,175,31,219,1191,2931,29,15,2975,20,20,100.0,Parisi
2021-12-05 05:24:46.923710,7019,71,False,312,480,220,167,21,161,677,2038,26,12,2076,16,16,100.0,Parisi
2021-12-05 05:24:46.923710,7019,72,False,508,727,232,153,37,180,1201,3038,22,6,3066,18,18,100.0,Parisi
2021-12-05 05:24:46.923710,7019,73,False,565,504,139,179,35,127,990,2539,25,12,2576,20,20,100.0,Parisi
2021-12-05 05:24:46.923710,7019,74,False,525,692,401,240,24,256,1246,3384,31,13,3428,22,22,100.0,Parisi
2021-12-05 05:24:46.923710,7019,75,False,415,460,140,144,34,151,1326,2670,19,8,2697,20,20,100.0,Parisi
2021-12-05 05:24:46.923710,7019,76,False,400,589,337,170,31,225,1054,2806,20,10,2836,18,18,100.0,Parisi
2021-12-05 05:24:46.923710,7019,77,False,460,562,206,134,27,140,1347,2876,28,9,2913,20,20,100.0,Parisi
2021-12-05 05:24:46.923710,7019,78,False,349,435,80,96,33,109,1636,2738,15,6,2759,20,20,100.0,Parisi
2021-12-05 05:24:46.923710,7019,79,False,549,642,293,245,38,226,1089,3082,30,9,3121,20,20,100.0,Parisi
2021-12-05 05:24:46.923710,7458,1348,False,596,970,502,362,39,209,417,3095,34,38,3167,25,25,100.0,Kast
2021-12-05 05:24:46.923710,7458,1349,False,535,893,443,297,36,182,493,2879,47,76,3002,25,25,100.0,Kast
2021-12-05 05:24:46.923710,7458,1350,False,434,621,172,143,29,128,637,2164,18,3,2185,19,19,100.0,Parisi
2021-12-05 05:24:46.923710,7458,1351,False,380,331,108,109,30,81,372,1411,17,13,1441,13,13,100.0,Boric
2021-12-05 05:24:46.923710,7036,153,False,553,492,759,201,45,208,688,2946,21,14,2981,19,19,100.0,Provoste
2021-12-05 05:24:46.923710,7036,154,False,963,771,921,239,60,250,1053,4257,29,24,4310,26,26,100.0,Parisi
2021-12-05 05:24:46.923710,7092,325,False,404,308,202,163,12,185,356,1630,18,8,1656,10,10,100.0,Boric
2021-12-05 05:24:46.923710,7092,331,False,514,297,82,135,28,130,527,1713,15,6,1734,10,10,100.0,Parisi
2021-12-05 05:24:46.923710,7092,332,False,716,364,118,177,41,172,643,2231,12,10,2253,15,15,100.0,Boric
2021-12-05 05:24:46.923710,7092,326,False,587,424,315,200,24,293,421,2264,34,12,2310,15,15,100.0,Boric
2021-12-05 05:24:46.923710,7092,327,False,684,512,269,336,34,346,611,2792,19,7,2818,17,17,100.0,Boric
2021-12-05 05:24:46.923710,7092,328,False,845,615,272,348,43,429,769,3321,21,9,3351,18,18,100.0,Boric
2021-12-05 05:24:46.923710,7092,329,False,1083,815,416,338,55,418,1017,4142,41,15,4198,25,25,100.0,Boric
2021-12-05 05:24:46.923710,7092,330,False,774,677,353,369,39,469,623,3304,41,8,3353,22,22,100.0,Boric
2021-12-05 05:24:46.923710,7213,2390,False,938,1037,218,540,45,177,279,3234,14,10,3258,20,20,100.0,Kast
2021-12-05 05:24:46.923710,7213,2388,False,860,1320,408,657,36,290,229,3800,25,11,3836,24,24,100.0,Kast
2021-12-05 05:24:46.923710,7213,2389,False,788,1239,441,496,34,226,246,3470,20,19,3509,23,23,100.0,Kast
2021-12-05 05:24:46.923710,7081,285,False,489,552,380,329,29,288,490,2557,36,14,2607,14,14,100.0,Kast
2021-12-05 05:24:46.923710,7081,284,False,523,589,463,275,40,244,501,2635,59,23,2717,14,14,100.0,Kast
2021-12-05 05:24:46.923710,7081,286,False,292,224,99,132,22,88,252,1109,3,3,1115,6,6,100.0,Boric
2021-12-05 05:24:46.923710,7003,2697,False,25,58,44,5,2,14,86,234,1,0,235,3,3,100.0,Parisi
2021-12-05 05:24:46.923710,7011,27,False,60,384,47,31,3,16,328,869,7,7,883,8,8,100.0,Kast
2021-12-05 05:24:46.923710,7578,2800,False,172,188,167,73,9,70,193,872,9,7,888,6,6,100.0,Parisi
2021-12-05 05:24:46.923710,7738,1467,False,86,212,189,61,7,39,93,687,3,6,696,4,4,100.0,Kast
2021-12-05 05:24:46.923710,7071,250,False,934,502,610,198,28,83,543,2898,34,28,2960,22,22,100.0,Boric
2021-12-05 05:24:46.923710,7379,1052,False,324,1420,340,212,31,121,219,2667,30,23,2720,20,20,100.0,Kast
2021-12-05 05:24:46.923710,7379,1053,False,362,810,146,120,32,83,350,1903,12,9,1924,15,15,100.0,Kast
2021-12-05 05:24:46.923710,7379,1054,False,343,1357,345,195,27,153,270,2690,22,15,2727,16,16,100.0,Kast
2021-12-05 05:24:46.923710,7379,1055,False,301,1293,314,188,34,103,209,2442,31,22,2495,18,18,100.0,Kast
2021-12-05 05:24:46.923710,7379,1056,False,412,1416,312,179,33,111,313,2776,27,32,2835,18,18,100.0,Kast
2021-12-05 05:24:46.923710,7562,1411,False,58,275,82,55,7,16,41,534,4,3,541,4,4,100.0,Kast
2021-12-05 05:24:46.923710,7171,1945,False,338,441,123,131,23,126,97,1279,6,2,1287,10,10,100.0,Kast
2021-12-05 05:24:46.923710,7171,1944,False,793,1131,242,291,62,226,249,2994,25,4,3023,23,23,100.0,Kast
2021-12-05 05:24:46.923710,7171,1946,False,730,564,245,326,46,232,143,2286,21,3,2310,16,16,100.0,Boric
2021-12-05 05:24:46.923710,7171,1947,False,603,640,264,339,32,244,209,2331,21,5,2357,18,18,100.0,Kast
2021-12-05 05:24:46.923710,7171,1948,False,825,676,263,351,57,327,246,2745,26,8,2779,18,18,100.0,Boric
2021-12-05 05:24:46.923710,7171,1949,False,564,567,281,286,26,245,162,2131,12,7,2150,15,15,100.0,Kast
2021-12-05 05:24:46.923710,7171,1950,False,627,435,237,198,36,222,180,1935,14,3,1952,14,14,100.0,Boric
2021-12-05 05:24:46.923710,7545,1264,False,109,1175,120,83,15,38,51,1591,14,8,1613,12,12,100.0,Kast
2021-12-05 05:24:46.923710,7420,1250,False,285,716,251,140,21,106,297,1816,12,8,1836,15,15,100.0,Kast
2021-12-05 05:24:46.923710,7420,1248,False,235,662,339,183,29,94,121,1663,17,12,1692,15,15,100.0,Kast
2021-12-05 05:24:46.923710,7420,1249,False,292,840,477,237,22,114,193,2175,30,27,2232,16,16,100.0,Kast
2021-12-05 05:24:46.923710,7420,1251,False,259,753,372,193,29,108,211,1925,19,18,1962,15,15,100.0,Kast
2021-12-05 05:24:46.923710,7655,1082,False,258,778,268,158,13,120,419,2014,13,14,2041,16,16,100.0,Kast
2021-12-05 05:24:46.923710,7564,1413,False,214,330,162,100,10,43,191,1050,9,9,1068,8,8,100.0,Kast
2021-12-05 05:24:46.923710,7060,230,False,247,333,261,175,29,95,272,1412,18,5,1435,15,15,100.0,Kast
2021-12-05 05:24:46.923710,7119,497,False,721,840,431,376,55,345,330,3098,23,10,3131,20,20,100.0,Kast
2021-12-05 05:24:46.923710,7119,498,False,546,532,275,207,45,251,185,2041,15,6,2062,12,12,100.0,Boric
2021-12-05 05:24:46.923710,7119,499,False,921,949,467,388,58,444,362,3589,30,21,3640,23,23,100.0,Kast
2021-12-05 05:24:46.923710,7115,482,False,442,390,85,161,28,90,243,1439,12,3,1454,10,10,100.0,Boric
2021-12-05 05:24:46.923710,7115,481,False,312,305,66,137,18,55,102,995,4,1,1000,6,6,100.0,Boric
2021-12-05 05:24:46.923710,7115,479,False,1111,1327,591,474,57,276,386,4222,51,18,4291,26,26,100.0,Kast
2021-12-05 05:24:46.923710,7115,480,False,985,1308,512,614,48,347,350,4164,39,22,4225,25,25,100.0,Kast
2021-12-05 05:24:46.923710,7634,1430,False,83,237,122,71,4,50,92,659,4,6,669,4,4,100.0,Kast
2021-12-05 05:24:46.923710,7465,1369,False,720,610,390,303,59,164,422,2668,19,15,2702,17,17,100.0,Boric
2021-12-05 05:24:46.923710,7465,1370,False,763,768,500,395,55,173,381,3035,21,27,3083,26,26,100.0,Kast
2021-12-05 05:24:46.923710,7465,1365,False,368,286,133,110,27,57,231,1212,11,5,1228,10,10,100.0,Boric
2021-12-05 05:24:46.923710,7465,1366,False,734,677,286,231,40,140,463,2571,21,17,2609,17,17,100.0,Boric
2021-12-05 05:24:46.923710,7465,1367,False,767,806,501,308,44,176,379,2981,23,27,3031,26,26,100.0,Kast
2021-12-05 05:24:46.923710,7465,1368,False,401,332,104,98,36,73,459,1503,16,9,1528,13,13,100.0,Parisi
2021-12-05 05:24:46.923710,7710,1463,False,985,773,390,339,48,123,326,2984,27,17,3028,18,18,100.0,Boric
2021-12-05 05:24:46.923710,7076,270,False,334,533,165,266,19,87,185,1589,10,5,1604,9,9,100.0,Kast
2021-12-05 05:24:46.923710,7088,307,False,702,562,373,298,27,245,707,2914,39,23,2976,21,21,100.0,Parisi
2021-12-05 05:24:46.923710,7088,308,False,518,428,290,293,20,238,435,2222,23,16,2261,15,15,100.0,Boric
2021-12-05 05:24:46.923710,7296,791,False,159,405,125,170,15,85,75,1034,10,15,1059,10,10,100.0,Kast
2021-12-05 05:24:46.923710,7726,1091,False,107,61,146,36,10,27,69,456,37,25,518,5,5,100.0,Provoste
2021-12-05 05:24:46.923710,7302,804,False,285,1138,308,371,19,114,219,2454,25,16,2495,15,15,100.0,Kast
2021-12-05 05:24:46.923710,7302,805,False,182,551,143,163,8,59,112,1218,13,11,1242,10,10,100.0,Kast
2021-12-05 05:24:46.923710,7302,806,False,318,1160,336,371,23,146,228,2582,38,30,2650,21,21,100.0,Kast
2021-12-05 05:24:46.923710,7302,807,False,396,1288,343,427,15,140,232,2841,36,21,2898,21,21,100.0,Kast
2021-12-05 05:24:46.923710,7302,808,False,456,1779,513,675,33,179,318,3953,38,23,4014,33,33,100.0,Kast
2021-12-05 05:24:46.923710,7302,809,False,322,834,265,263,12,84,177,1957,27,15,1999,16,16,100.0,Kast
2021-12-05 05:24:46.923710,7683,2666,False,56,187,74,51,5,25,41,439,7,4,450,3,3,100.0,Kast
2021-12-05 05:24:46.923710,7162,1886,False,677,539,138,196,57,191,199,1997,10,6,2013,13,13,100.0,Boric
2021-12-05 05:24:46.923710,7162,1887,False,626,462,149,176,43,174,183,1813,9,7,1829,12,12,100.0,Boric
2021-12-05 05:24:46.923710,7162,1888,False,1146,753,262,425,69,336,327,3318,23,11,3352,20,20,100.0,Boric
2021-12-05 05:24:46.923710,7162,1892,False,689,564,304,289,42,290,216,2394,18,6,2418,15,15,100.0,Boric
2021-12-05 05:24:46.923710,7162,1889,False,612,438,152,178,31,190,185,1786,10,5,1801,12,12,100.0,Boric
2021-12-05 05:24:46.923710,7162,1890,False,941,624,296,323,71,300,258,2813,14,7,2834,19,19,100.0,Boric
2021-12-05 05:24:46.923710,7162,1891,False,806,654,297,405,39,335,277,2813,23,9,2845,20,20,100.0,Boric
2021-12-05 05:24:46.923710,7162,1893,False,788,517,203,243,47,289,251,2338,14,7,2359,15,15,100.0,Boric
2021-12-05 05:24:46.923710,7162,1894,False,877,563,248,316,50,330,316,2700,16,5,2721,18,18,100.0,Boric
2021-12-05 05:24:46.923710,7162,1895,False,796,753,340,457,44,370,251,3011,24,9,3044,22,22,100.0,Boric
2021-12-05 05:24:46.923710,7162,1896,False,864,733,363,463,56,402,231,3112,30,10,3152,21,21,100.0,Boric
2021-12-05 05:24:46.923710,7162,1897,False,815,590,219,341,44,329,300,2638,30,6,2674,18,18,100.0,Boric
2021-12-05 05:24:46.923710,7055,223,False,216,264,241,146,13,101,395,1376,21,33,1430,11,11,100.0,Parisi
2021-12-05 05:24:46.923710,7156,1817,False,628,381,227,214,58,323,299,2130,5,11,2146,16,16,100.0,Boric
2021-12-05 05:24:46.923710,7156,1818,False,739,407,267,249,67,383,281,2393,22,6,2421,16,16,100.0,Boric
2021-12-05 05:24:46.923710,7156,1821,False,814,407,279,281,55,324,241,2401,10,6,2417,15,15,100.0,Boric
2021-12-05 05:24:46.923710,7156,1819,False,697,438,352,238,66,319,170,2280,26,18,2324,19,19,100.0,Boric
2021-12-05 05:24:46.923710,7156,1822,False,713,461,346,265,59,401,259,2504,14,7,2525,19,19,100.0,Boric
2021-12-05 05:24:46.923710,7156,1823,False,688,458,329,221,54,335,214,2299,10,12,2321,16,16,100.0,Boric
2021-12-05 05:24:46.923710,7156,1824,False,708,458,311,252,68,391,229,2417,20,13,2450,19,19,100.0,Boric
2021-12-05 05:24:46.923710,7156,1825,False,779,478,354,223,83,344,242,2503,13,11,2527,17,17,100.0,Boric
2021-12-05 05:24:46.923710,7156,1826,False,1049,605,395,261,107,485,399,3301,27,9,3337,22,22,100.0,Boric
2021-12-05 05:24:46.923710,7156,1827,False,734,462,310,274,77,407,317,2581,20,12,2613,19,19,100.0,Boric
2021-12-05 05:24:46.923710,7156,1828,False,1001,605,343,325,104,510,388,3276,28,9,3313,23,23,100.0,Boric
2021-12-05 05:24:46.923710,7156,1829,False,881,506,271,173,119,291,239,2480,12,14,2506,15,15,100.0,Boric
2021-12-05 05:24:46.923710,7156,1830,False,876,477,380,233,71,346,250,2633,17,16,2666,18,18,100.0,Boric
2021-12-05 05:24:46.923710,7156,1831,False,570,370,248,224,49,331,200,1992,20,13,2025,15,15,100.0,Boric
2021-12-05 05:24:46.923710,7156,1832,False,932,534,381,269,82,446,313,2957,16,22,2995,21,21,100.0,Boric
2021-12-05 05:24:46.923710,7156,1833,False,522,166,69,80,48,150,239,1274,4,3,1281,10,10,100.0,Boric
2021-12-05 05:24:46.923710,7156,1820,False,545,366,254,235,57,299,165,1921,32,9,1962,17,17,100.0,Boric
2021-12-05 05:24:46.923710,7156,1834,False,829,308,126,151,69,220,362,2065,8,7,2080,17,17,100.0,Boric
2021-12-05 05:24:46.923710,7156,1835,False,645,270,115,106,53,188,316,1693,18,5,1716,13,13,100.0,Boric
2021-12-05 05:24:46.923710,7156,1836,False,1000,645,456,341,89,523,275,3329,38,19,3386,23,23,100.0,Boric
2021-12-05 05:24:46.923710,7324,2784,False,119,425,192,154,14,76,108,1088,16,10,1114,11,11,100.0,Kast
2021-12-05 05:24:46.923710,7397,1170,False,244,621,146,227,5,76,110,1429,4,3,1436,12,12,100.0,Kast
2021-12-05 05:24:46.923710,7397,1158,False,545,962,148,280,21,92,373,2421,17,8,2446,23,23,100.0,Kast
2021-12-05 05:24:46.923710,7397,1159,False,430,1140,280,323,18,127,212,2530,18,5,2553,20,20,100.0,Kast
2021-12-05 05:24:46.923710,7397,1173,False,626,856,136,284,25,122,430,2479,16,5,2500,22,22,100.0,Kast
2021-12-05 05:24:46.923710,7397,1160,False,375,1079,293,246,21,114,156,2284,18,8,2310,18,18,100.0,Kast
2021-12-05 05:24:46.923710,7397,1161,False,619,1271,272,519,18,121,215,3035,17,4,3056,20,20,100.0,Kast
2021-12-05 05:24:46.923710,7397,1162,False,460,1039,236,355,16,94,167,2367,10,4,2381,18,18,100.0,Kast
2021-12-05 05:24:46.923710,7397,1163,False,415,645,89,226,20,66,357,1818,11,3,1832,18,18,100.0,Kast
2021-12-05 05:24:46.923710,7397,1164,False,341,1021,281,301,12,117,133,2206,18,11,2235,21,21,100.0,Kast
2021-12-05 05:24:46.923710,7397,1165,False,360,956,249,273,15,67,101,2021,12,7,2040,20,20,100.0,Kast
2021-12-05 05:24:46.923710,7397,1166,False,343,1059,301,377,15,90,103,2288,11,9,2308,21,21,100.0,Kast
2021-12-05 05:24:46.923710,7397,1174,False,476,1045,165,318,24,79,225,2332,15,7,2354,18,18,100.0,Kast
2021-12-05 05:24:46.923710,7397,1167,False,474,1092,283,347,14,120,132,2462,19,9,2490,22,22,100.0,Kast
2021-12-05 05:24:46.923710,7397,1168,False,447,1133,347,303,17,136,165,2548,16,13,2577,24,24,100.0,Kast
2021-12-05 05:24:46.923710,7397,1169,False,455,926,181,293,25,88,245,2213,12,8,2233,21,21,100.0,Kast
2021-12-05 05:24:46.923710,7397,1171,False,513,1406,326,369,23,138,239,3014,21,8,3043,24,24,100.0,Kast
2021-12-05 05:24:46.923710,7397,1172,False,600,1565,319,425,35,122,232,3298,22,9,3329,24,24,100.0,Kast
2021-12-05 05:24:46.923710,7468,1378,False,216,285,164,116,10,67,100,958,14,18,990,7,7,100.0,Kast
2021-12-05 05:24:46.923710,7751,1099,False,199,895,201,212,25,113,307,1952,21,10,1983,17,17,100.0,Kast
2021-12-05 05:24:46.923710,7480,1396,False,213,365,189,94,4,43,89,997,11,20,1028,12,12,100.0,Kast
2021-12-05 05:24:46.923710,7689,1435,False,390,557,172,203,23,88,194,1627,15,13,1655,10,10,100.0,Kast
2021-12-05 05:24:46.923710,7534,2464,False,285,480,134,132,17,68,98,1214,7,7,1228,8,8,100.0,Kast
2021-12-05 05:24:46.923710,7534,2463,False,734,1107,416,386,26,219,230,3118,20,11,3149,19,19,100.0,Kast
2021-12-05 05:24:46.923710,7714,46,False,44,44,37,12,2,19,55,213,2,1,216,2,2,100.0,Parisi
2021-12-05 05:24:46.923710,7306,813,False,203,827,280,227,7,68,109,1721,35,10,1766,16,16,100.0,Kast
2021-12-05 05:24:46.923710,7306,814,False,259,892,303,164,9,72,126,1825,28,35,1888,18,18,100.0,Kast
2021-12-05 05:24:46.923710,7030,134,False,517,337,609,161,18,139,607,2388,23,10,2421,18,18,100.0,Provoste
2021-12-05 05:24:46.923710,7030,135,False,536,365,664,117,33,124,642,2481,22,10,2513,20,20,100.0,Provoste
2021-12-05 05:24:46.923710,7061,231,False,323,304,294,114,24,96,425,1580,21,15,1616,15,15,100.0,Parisi
2021-12-05 05:24:46.923710,7475,1388,False,13,24,29,4,3,9,11,93,3,3,99,3,3,100.0,Provoste
2021-12-05 05:24:46.923710,7066,244,False,220,268,217,104,12,74,247,1142,11,22,1175,9,9,100.0,Kast
2021-12-05 05:24:46.923710,7250,630,False,557,853,451,429,21,170,352,2833,16,12,2861,23,23,100.0,Kast
2021-12-05 05:24:46.923710,7250,631,False,368,706,390,424,13,168,234,2303,18,13,2334,18,18,100.0,Kast
2021-12-05 05:24:46.923710,7403,1200,False,105,464,184,90,3,38,105,989,13,10,1012,9,9,100.0,Kast
2021-12-05 05:24:46.923710,7010,26,False,1,17,10,2,0,1,12,43,2,1,46,1,1,100.0,Kast
2021-12-05 05:24:46.923710,7609,2519,False,265,2371,216,1357,10,37,31,4287,11,6,4304,16,16,100.0,Kast
2021-12-05 05:24:46.923710,7609,2517,False,335,2270,241,1208,4,72,92,4222,16,6,4244,18,18,100.0,Kast
2021-12-05 05:24:46.923710,7609,2516,False,282,1471,142,924,4,36,35,2894,5,3,2902,12,12,100.0,Kast
2021-12-05 05:24:46.923710,7609,2518,False,334,1725,173,1024,9,46,53,3364,12,2,3378,14,14,100.0,Kast
2021-12-05 05:24:46.923710,7338,879,False,904,836,223,414,68,198,657,3300,23,4,3327,19,19,100.0,Boric
2021-12-05 05:24:46.923710,7338,880,False,752,935,416,361,43,282,551,3340,25,13,3378,20,20,100.0,Kast
2021-12-05 05:24:46.923710,7338,881,False,601,678,180,342,51,177,418,2447,10,7,2464,12,12,100.0,Kast
2021-12-05 05:24:46.923710,7338,882,False,1083,787,174,336,68,220,1080,3748,19,7,3774,25,25,100.0,Boric
2021-12-05 05:24:46.923710,7338,883,False,606,864,472,414,34,294,377,3061,24,21,3106,20,20,100.0,Kast
2021-12-05 05:24:46.923710,7338,884,False,548,691,332,348,31,235,461,2646,22,3,2671,15,15,100.0,Kast
2021-12-05 05:24:46.923710,7338,885,False,878,1105,387,388,50,246,602,3656,25,5,3686,20,20,100.0,Kast
2021-12-05 05:24:46.923710,7338,886,False,1115,1174,592,603,63,388,702,4637,26,12,4675,24,24,100.0,Kast
2021-12-05 05:24:46.923710,7338,887,False,915,1089,703,472,48,363,597,4187,23,16,4226,25,25,100.0,Kast
2021-12-05 05:24:46.923710,7338,888,False,704,938,413,397,35,334,482,3303,31,12,3346,20,20,100.0,Kast
2021-12-05 05:24:46.923710,7497,1496,False,526,391,264,131,22,75,164,1573,24,19,1616,17,17,100.0,Boric
2021-12-05 05:24:46.923710,7307,2727,False,615,1099,374,345,32,190,354,3009,19,6,3034,20,20,100.0,Kast
2021-12-05 05:24:46.923710,7307,2749,False,675,1009,380,334,32,160,456,3046,21,9,3076,20,20,100.0,Kast
2021-12-05 05:24:46.923710,7307,2728,False,734,1141,450,501,25,180,500,3531,22,6,3559,21,21,100.0,Kast
2021-12-05 05:24:46.923710,7307,2729,False,532,580,154,260,32,75,459,2092,10,4,2106,15,15,100.0,Kast
2021-12-05 05:24:46.923710,7307,2730,False,546,1122,422,443,26,183,354,3096,23,15,3134,20,20,100.0,Kast
2021-12-05 05:24:46.923710,7307,2731,False,630,1169,446,389,35,202,357,3228,25,10,3263,20,20,100.0,Kast
2021-12-05 05:24:46.923710,7307,2732,False,720,829,223,377,57,124,382,2712,11,3,2726,16,16,100.0,Kast
2021-12-05 05:24:46.923710,7307,2733,False,513,1099,388,437,16,173,362,2988,24,7,3019,20,20,100.0,Kast
2021-12-05 05:24:46.923710,7307,2734,False,556,1033,419,430,23,147,334,2942,21,8,2971,21,21,100.0,Kast
2021-12-05 05:24:46.923710,7307,2735,False,698,1160,388,502,31,161,354,3294,24,12,3330,18,18,100.0,Kast
2021-12-05 05:24:46.923710,7307,2750,False,756,1234,410,508,32,181,398,3519,13,6,3538,18,18,100.0,Kast
2021-12-05 05:24:46.923710,7307,2736,False,902,1111,296,459,42,166,623,3599,24,13,3636,23,23,100.0,Kast
2021-12-05 05:24:46.923710,7307,2737,False,558,807,257,278,21,85,296,2302,9,6,2317,12,12,100.0,Kast
2021-12-05 05:24:46.923710,7307,2738,False,657,1008,349,369,34,193,502,3112,21,15,3148,18,18,100.0,Kast
2021-12-05 05:24:46.923710,7307,2739,False,620,937,280,311,37,113,294,2592,12,10,2614,14,14,100.0,Kast
2021-12-05 05:24:46.923710,7307,2740,False,456,733,244,250,26,95,313,2117,10,4,2131,12,12,100.0,Kast
2021-12-05 05:24:46.923710,7307,2741,False,241,453,233,199,11,94,124,1355,3,2,1360,10,10,100.0,Kast
2021-12-05 05:24:46.923710,7307,2742,False,640,1252,434,498,21,225,446,3516,28,14,3558,23,23,100.0,Kast
2021-12-05 05:24:46.923710,7307,2743,False,806,1506,696,554,26,263,509,4360,204,27,4591,28,28,100.0,Kast
2021-12-05 05:24:46.923710,7307,2744,False,677,1224,402,461,31,212,504,3511,27,18,3556,23,23,100.0,Kast
2021-12-05 05:24:46.923710,7307,2745,False,507,858,419,315,26,151,301,2577,21,8,2606,20,20,100.0,Kast
2021-12-05 05:24:46.923710,7307,2746,False,592,830,371,406,28,149,383,2759,35,5,2799,17,17,100.0,Kast
2021-12-05 05:24:46.923710,7307,2747,False,593,1035,494,366,25,188,402,3103,19,14,3136,20,20,100.0,Kast
2021-12-05 05:24:46.923710,7307,2748,False,365,631,298,301,25,125,209,1954,22,6,1982,15,15,100.0,Kast
2021-12-05 05:24:46.923710,7575,2797,False,772,1568,660,612,36,377,682,4707,35,18,4760,28,28,100.0,Kast
2021-12-05 05:24:46.923710,7575,2798,False,540,1221,542,376,34,259,522,3494,41,12,3547,21,21,100.0,Kast
2021-12-05 05:24:46.923710,7575,2799,False,490,743,256,252,25,157,461,2384,17,5,2406,15,15,100.0,Kast
2021-12-05 05:24:46.923710,7247,621,False,624,978,581,597,30,332,573,3715,51,39,3805,26,26,100.0,Kast
2021-12-05 05:24:46.923710,7247,622,False,659,895,523,394,35,189,598,3293,25,37,3355,21,21,100.0,Kast
2021-12-05 05:24:46.923710,7247,623,False,671,1027,703,549,37,323,608,3918,52,35,4005,26,26,100.0,Kast
2021-12-05 05:24:46.923710,7247,624,False,586,564,173,257,20,136,558,2294,15,8,2317,17,17,100.0,Boric
2021-12-05 05:24:46.923710,7544,509,False,308,212,192,121,12,109,150,1104,18,10,1132,8,8,100.0,Boric
2021-12-05 05:24:46.923710,7601,131,False,17,41,26,7,6,14,64,175,1,1,177,2,2,100.0,Parisi
2021-12-05 05:24:46.923710,7423,1259,False,310,850,372,279,35,162,330,2338,47,26,2411,15,15,100.0,Kast
2021-12-05 05:24:46.923710,7423,1260,False,479,970,408,270,51,193,492,2863,82,40,2985,18,18,100.0,Kast
2021-12-05 05:24:46.923710,7477,1390,False,450,350,221,139,32,88,401,1681,18,11,1710,12,12,100.0,Boric
2021-12-05 05:24:46.923710,7477,1391,False,697,795,684,343,53,176,568,3316,28,34,3378,26,26,100.0,Kast
2021-12-05 05:24:46.923710,7436,2627,False,93,161,76,42,6,37,66,481,10,11,502,4,4,100.0,Kast
2021-12-05 05:24:46.923710,7020,80,False,497,576,360,217,18,193,580,2441,20,9,2470,16,16,100.0,Parisi
2021-12-05 05:24:46.923710,7681,2664,False,92,180,77,44,6,20,163,582,8,5,595,4,4,100.0,Kast
2021-12-05 05:24:46.923710,7493,1492,False,253,343,121,74,12,69,179,1051,11,12,1074,10,10,100.0,Kast
2021-12-05 05:24:46.923710,7665,2550,False,901,834,314,583,41,212,181,3066,17,10,3093,16,16,100.0,Boric
2021-12-05 05:24:46.923710,7665,2549,False,497,420,127,235,34,77,106,1496,7,0,1503,8,8,100.0,Boric
2021-12-05 05:24:46.923710,7664,2545,False,1245,819,215,477,51,267,355,3429,22,7,3458,18,18,100.0,Boric
2021-12-05 05:24:46.923710,7664,2546,False,1332,1035,273,538,56,253,285,3772,20,12,3804,18,18,100.0,Boric
2021-12-05 05:24:46.923710,7664,2547,False,1169,831,241,489,53,313,262,3358,34,4,3396,16,16,100.0,Boric
2021-12-05 05:24:46.923710,7664,2548,False,1355,826,244,531,69,276,234,3535,22,2,3559,16,16,100.0,Boric
2021-12-05 05:24:46.923710,7329,2792,False,369,558,371,287,20,92,216,1913,26,22,1961,15,15,100.0,Kast
2021-12-05 05:24:46.923710,7456,1346,False,163,233,73,83,12,24,82,670,2,11,683,9,9,100.0,Kast
2021-12-05 05:24:46.923710,7500,1499,False,357,428,264,176,12,49,101,1387,24,29,1440,13,13,100.0,Kast
2021-12-05 05:24:46.923710,7230,562,False,770,675,323,351,32,286,556,2993,25,14,3032,20,20,100.0,Boric
2021-12-05 05:24:46.923710,7230,563,False,557,500,319,227,26,236,452,2317,39,21,2377,15,15,100.0,Boric
2021-12-05 05:24:46.923710,7525,2701,False,86,194,151,52,4,39,289,815,13,4,832,8,8,100.0,Parisi
2021-12-05 05:24:46.923710,7327,2788,False,433,1145,633,395,19,173,514,3312,24,26,3362,24,24,100.0,Kast
2021-12-05 05:24:46.923710,7327,2789,False,518,1017,570,283,22,171,483,3064,34,34,3132,25,25,100.0,Kast
2021-12-05 05:24:46.923710,7753,1101,False,62,240,77,43,6,40,148,616,7,5,628,4,4,100.0,Kast
2021-12-05 05:24:46.923710,7314,2763,False,170,493,104,146,18,60,223,1214,13,6,1233,11,11,100.0,Kast
2021-12-05 05:24:46.923710,7314,2764,False,328,1411,461,363,27,133,296,3019,22,33,3074,22,22,100.0,Kast
2021-12-05 05:24:46.923710,7314,2765,False,285,1380,440,422,16,132,248,2923,33,24,2980,21,21,100.0,Kast
2021-12-05 05:24:46.923710,7731,2810,False,40,320,43,72,4,31,37,547,3,3,553,4,4,100.0,Kast
2021-12-05 05:24:46.923710,7242,603,False,391,461,173,262,12,151,214,1664,15,6,1685,11,11,100.0,Kast
2021-12-05 05:24:46.923710,7242,604,False,378,485,171,213,12,140,208,1607,22,17,1646,11,11,100.0,Kast
2021-12-05 05:24:46.923710,7548,1407,False,47,131,37,28,2,21,54,320,7,4,331,3,3,100.0,Kast
2021-12-05 05:24:46.923710,7293,779,False,525,835,482,362,21,272,391,2888,42,29,2959,21,21,100.0,Kast
2021-12-05 05:24:46.923710,7293,780,False,397,516,215,183,30,137,323,1801,13,14,1828,12,12,100.0,Kast
2021-12-05 05:24:46.923710,7293,781,False,590,789,501,289,25,265,418,2877,39,36,2952,22,22,100.0,Kast
2021-12-05 05:24:46.923710,7012,28,False,17,419,18,10,4,5,433,906,8,1,915,14,14,100.0,Parisi
2021-12-05 05:24:46.923710,7550,816,False,204,428,165,218,11,85,187,1298,10,12,1320,9,9,100.0,Kast
2021-12-05 05:24:46.923710,7125,1559,False,263,459,58,161,15,110,321,1387,6,5,1398,12,12,100.0,Kast
2021-12-05 05:24:46.923710,7125,1565,False,485,741,234,407,24,270,244,2405,24,9,2438,15,15,100.0,Kast
2021-12-05 05:24:46.923710,7125,1572,False,537,711,233,400,30,234,227,2372,14,10,2396,14,14,100.0,Kast
2021-12-05 05:24:46.923710,7125,1560,False,346,709,227,406,26,248,191,2153,27,18,2198,15,15,100.0,Kast
2021-12-05 05:24:46.923710,7125,1564,False,469,785,137,492,19,100,176,2178,8,2,2188,14,14,100.0,Kast
2021-12-05 05:24:46.923710,7125,1561,False,510,853,313,432,21,285,260,2674,21,19,2714,18,18,100.0,Kast
2021-12-05 05:24:46.923710,7125,1562,False,332,351,52,234,21,78,165,1233,11,3,1247,10,10,100.0,Kast
2021-12-05 05:24:46.923710,7125,1563,False,304,336,40,141,14,97,311,1243,8,5,1256,10,10,100.0,Kast
2021-12-05 05:24:46.923710,7125,1570,False,481,597,129,249,23,152,219,1850,7,5,1862,11,11,100.0,Kast
2021-12-05 05:24:46.923710,7125,1566,False,571,945,292,389,40,277,290,2804,27,20,2851,20,20,100.0,Kast
2021-12-05 05:24:46.923710,7125,1568,False,781,1094,180,642,40,208,445,3390,14,12,3416,24,24,100.0,Kast
2021-12-05 05:24:46.923710,7125,1567,False,590,839,235,360,23,236,381,2664,10,7,2681,18,18,100.0,Kast
2021-12-05 05:24:46.923710,7125,1571,False,526,784,233,320,24,226,274,2387,24,8,2419,15,15,100.0,Kast
2021-12-05 05:24:46.923710,7125,1569,False,557,1054,387,475,38,299,272,3082,48,29,3159,22,22,100.0,Kast
2021-12-05 05:24:46.923710,7384,1113,False,343,1252,192,146,30,133,313,2409,24,31,2464,17,17,100.0,Kast
2021-12-05 05:24:46.923710,7384,1114,False,246,1270,201,178,19,116,271,2301,24,14,2339,15,15,100.0,Kast
2021-12-05 05:24:46.923710,7384,1115,False,189,985,180,141,20,92,160,1767,25,14,1806,14,14,100.0,Kast
2021-12-05 05:24:46.923710,7384,1116,False,233,1214,222,155,10,87,214,2135,24,36,2195,16,16,100.0,Kast
2021-12-05 05:24:46.923710,7241,600,False,396,380,117,164,16,116,352,1541,14,5,1560,11,11,100.0,Boric
2021-12-05 05:24:46.923710,7241,601,False,602,792,442,346,36,223,410,2851,26,19,2896,19,19,100.0,Kast
2021-12-05 05:24:46.923710,7241,602,False,528,708,415,433,22,243,377,2726,19,15,2760,18,18,100.0,Kast
2021-12-05 05:24:46.923710,7062,233,False,578,481,595,205,38,122,453,2472,30,25,2527,19,19,100.0,Provoste
2021-12-05 05:24:46.923710,7062,232,False,634,404,675,172,29,89,484,2487,26,33,2546,20,20,100.0,Provoste
2021-12-05 05:24:46.923710,7412,1233,False,89,419,108,83,5,43,42,789,13,5,807,5,5,100.0,Kast
2021-12-05 05:24:46.923710,7333,832,False,704,922,321,393,39,234,428,3041,16,13,3070,20,20,100.0,Kast
2021-12-05 05:24:46.923710,7333,833,False,1260,1295,447,664,61,202,457,4386,21,11,4418,26,26,100.0,Kast
2021-12-05 05:24:46.923710,7333,834,False,699,1086,361,458,39,210,397,3250,18,9,3277,21,21,100.0,Kast
2021-12-05 05:24:46.923710,7333,835,False,342,440,195,187,19,82,176,1441,13,10,1464,9,9,100.0,Kast
2021-12-05 05:24:46.923710,7333,836,False,1288,749,156,361,106,166,811,3637,28,8,3673,25,25,100.0,Boric
2021-12-05 05:24:46.923710,7333,837,False,752,1035,432,422,49,208,398,3296,24,17,3337,20,20,100.0,Kast
2021-12-05 05:24:46.923710,7333,838,False,1041,1018,303,455,66,150,391,3424,17,4,3445,22,22,100.0,Boric
2021-12-05 05:24:46.923710,7333,839,False,769,1077,440,406,39,208,370,3309,14,11,3334,20,20,100.0,Kast
2021-12-05 05:24:46.923710,7333,841,False,359,592,232,243,21,124,219,1790,8,6,1804,12,12,100.0,Kast
2021-12-05 05:24:46.923710,7333,840,False,1056,1189,287,470,55,146,441,3644,18,7,3669,20,20,100.0,Kast
2021-12-05 05:24:46.923710,7333,842,False,965,716,154,293,72,115,838,3153,33,3,3189,23,23,100.0,Boric
2021-12-05 05:24:46.923710,7333,843,False,659,978,376,336,35,185,292,2861,14,16,2891,21,21,100.0,Kast
2021-12-05 05:24:46.923710,7333,844,False,579,840,342,290,30,145,279,2505,15,14,2534,16,16,100.0,Kast
2021-12-05 05:24:46.923710,7333,845,False,629,1050,378,466,35,144,226,2928,9,11,2948,21,21,100.0,Kast
2021-12-05 05:24:46.923710,7333,846,False,552,757,265,292,30,141,358,2395,16,7,2418,15,15,100.0,Kast
2021-12-05 05:24:46.923710,7333,847,False,681,858,317,420,43,161,392,2872,12,8,2892,18,18,100.0,Kast
2021-12-05 05:24:46.923710,7333,848,False,925,1156,308,374,40,125,475,3403,25,7,3435,20,20,100.0,Kast
2021-12-05 05:24:46.923710,7333,849,False,648,973,396,469,39,205,303,3033,29,10,3072,21,21,100.0,Kast
2021-12-05 05:24:46.923710,7333,850,False,694,945,328,402,36,192,365,2962,15,6,2983,20,20,100.0,Kast
2021-12-05 05:24:46.923710,7333,851,False,656,812,253,313,42,140,370,2586,26,8,2620,16,16,100.0,Kast
2021-12-05 05:24:46.923710,7333,852,False,432,548,214,215,29,107,255,1800,13,8,1821,12,12,100.0,Kast
2021-12-05 05:24:46.923710,7333,853,False,1260,1391,442,663,52,205,443,4456,28,9,4493,22,22,100.0,Kast
2021-12-05 05:24:46.923710,7333,854,False,605,988,377,469,46,190,230,2905,14,9,2928,21,21,100.0,Kast
2021-12-05 05:24:46.923710,7333,855,False,554,942,352,336,38,138,267,2627,13,17,2657,22,22,100.0,Kast
2021-12-05 05:24:46.923710,7109,440,False,881,1941,279,975,45,134,248,4503,29,11,4543,18,18,100.0,Kast
2021-12-05 05:24:46.923710,7109,441,False,817,1480,211,768,41,115,296,3728,21,3,3752,18,18,100.0,Kast
2021-12-05 05:24:46.923710,7109,442,False,560,1479,244,623,21,123,229,3279,8,9,3296,14,14,100.0,Kast
2021-12-05 05:24:46.923710,7109,446,False,434,721,167,294,19,101,232,1968,6,10,1984,10,10,100.0,Kast
2021-12-05 05:24:46.923710,7109,443,False,849,1152,421,599,47,275,380,3723,30,24,3777,20,20,100.0,Kast
2021-12-05 05:24:46.923710,7109,444,False,850,1586,323,842,25,213,374,4213,16,6,4235,20,20,100.0,Kast
2021-12-05 05:24:46.923710,7109,445,False,709,998,384,601,29,290,369,3380,28,13,3421,19,19,100.0,Kast
2021-12-05 05:24:46.923710,7760,1472,False,95,261,180,45,3,37,59,680,5,7,692,5,5,100.0,Kast
2021-12-05 05:24:46.923710,7620,2534,False,1128,813,282,768,55,165,194,3405,26,8,3439,18,18,100.0,Boric
2021-12-05 05:24:46.923710,7620,2527,False,613,481,200,361,33,263,208,2159,5,3,2167,14,14,100.0,Boric
2021-12-05 05:24:46.923710,7620,2531,False,988,516,249,495,47,169,159,2623,19,9,2651,14,14,100.0,Boric
2021-12-05 05:24:46.923710,7620,2530,False,536,412,204,355,13,127,85,1732,12,5,1749,11,11,100.0,Boric
2021-12-05 05:24:46.923710,7620,2528,False,622,409,151,336,34,198,222,1972,9,10,1991,13,13,100.0,Boric
2021-12-05 05:24:46.923710,7620,2529,False,815,370,137,349,53,159,259,2142,14,4,2160,13,13,100.0,Boric
2021-12-05 05:24:46.923710,7620,2532,False,1582,1076,484,816,49,270,175,4452,20,4,4476,22,22,100.0,Boric
2021-12-05 05:24:46.923710,7620,2533,False,708,367,146,339,35,158,157,1910,18,2,1930,11,11,100.0,Boric
2021-12-05 05:24:46.923710,7620,2535,False,1528,898,372,787,79,225,161,4050,22,11,4083,20,20,100.0,Boric
2021-12-05 05:24:46.923710,7286,755,False,449,653,391,291,27,168,602,2581,22,18,2621,17,17,100.0,Kast
2021-12-05 05:24:46.923710,7286,756,False,454,578,210,261,33,138,611,2285,14,6,2305,15,15,100.0,Parisi
2021-12-05 05:24:46.923710,7286,759,False,406,799,455,414,28,237,554,2893,30,19,2942,20,20,100.0,Kast
2021-12-05 05:24:46.923710,7286,757,False,694,1058,540,516,46,274,930,4058,45,27,4130,26,26,100.0,Kast
2021-12-05 05:24:46.923710,7286,758,False,494,706,558,336,25,188,569,2876,26,30,2932,20,20,100.0,Kast
2021-12-05 05:24:46.923710,7555,1408,False,141,244,176,72,5,67,138,843,11,16,870,6,6,100.0,Kast
2021-12-05 05:24:46.923710,7380,1057,False,168,776,137,60,15,61,107,1324,16,15,1355,12,12,100.0,Kast
2021-12-05 05:24:46.923710,7380,1058,False,162,781,169,78,11,78,108,1387,7,6,1400,11,11,100.0,Kast
2021-12-05 05:24:46.923710,7541,2649,False,118,296,92,80,10,59,59,714,16,14,744,5,5,100.0,Kast
2021-12-05 05:24:46.923710,7541,2650,False,221,332,111,92,27,63,107,953,23,21,997,6,6,100.0,Kast
2021-12-05 05:24:46.923710,7034,151,False,452,362,407,130,30,108,499,1988,8,5,2001,16,16,100.0,Parisi
2021-12-05 05:24:46.923710,7034,139,False,850,969,802,300,56,211,1057,4245,31,16,4292,30,30,100.0,Parisi
2021-12-05 05:24:46.923710,7034,148,False,534,758,863,253,24,147,469,3048,17,10,3075,25,25,100.0,Provoste
2021-12-05 05:24:46.923710,7034,140,False,794,821,487,246,53,150,812,3363,23,6,3392,25,25,100.0,Kast
2021-12-05 05:24:46.923710,7034,152,False,809,554,274,208,66,148,984,3043,26,8,3077,26,26,100.0,Parisi
2021-12-05 05:24:46.923710,7034,141,False,450,437,461,149,19,97,409,2022,15,7,2044,15,15,100.0,Provoste
2021-12-05 05:24:46.923710,7034,147,False,562,813,802,350,25,209,471,3232,32,9,3273,26,26,100.0,Kast
2021-12-05 05:24:46.923710,7034,149,False,928,850,670,329,44,232,685,3738,26,3,3767,26,26,100.0,Boric
2021-12-05 05:24:46.923710,7034,150,False,636,762,606,245,45,197,994,3485,17,8,3510,30,30,100.0,Parisi
2021-12-05 05:24:46.923710,7034,142,False,621,428,263,147,59,152,1120,2790,20,10,2820,23,23,100.0,Parisi
2021-12-05 05:24:46.923710,7034,143,False,843,962,925,435,47,287,886,4385,32,10,4427,30,30,100.0,Kast
2021-12-05 05:24:46.923710,7034,144,False,621,790,858,281,49,210,605,3414,37,14,3465,25,25,100.0,Provoste
2021-12-05 05:24:46.923710,7034,145,False,824,949,951,362,37,264,754,4141,23,10,4174,30,30,100.0,Provoste
2021-12-05 05:24:46.923710,7034,146,False,757,549,309,223,51,140,713,2742,12,7,2761,24,24,100.0,Boric
2021-12-05 05:24:46.923710,7347,941,False,57,292,93,74,6,47,75,644,8,5,657,5,5,100.0,Kast
2021-12-05 05:24:46.923710,7047,188,False,1064,1158,660,685,51,470,758,4846,44,26,4916,36,36,100.0,Kast
2021-12-05 05:24:46.923710,7047,202,False,1158,1110,559,480,58,371,898,4634,37,23,4694,31,31,100.0,Boric
2021-12-05 05:24:46.923710,7047,201,False,830,773,401,427,33,287,641,3392,23,8,3423,22,22,100.0,Boric
2021-12-05 05:24:46.923710,7047,200,False,950,997,517,503,35,386,765,4153,36,23,4212,30,30,100.0,Kast
2021-12-05 05:24:46.923710,7047,199,False,841,575,159,252,49,207,1032,3115,25,7,3147,25,25,100.0,Parisi
2021-12-05 05:24:46.923710,7047,198,False,1376,1311,505,463,87,347,957,5046,35,13,5094,30,30,100.0,Boric
2021-12-05 05:24:46.923710,7047,197,False,652,796,446,427,33,283,418,3055,31,19,3105,25,25,100.0,Kast
2021-12-05 05:24:46.923710,7047,196,False,820,620,220,260,55,172,558,2705,14,11,2730,20,20,100.0,Boric
2021-12-05 05:24:46.923710,7047,195,False,818,445,119,206,50,187,942,2767,18,8,2793,23,23,100.0,Parisi
2021-12-05 05:24:46.923710,7047,189,False,1086,622,242,278,66,233,653,3180,8,7,3195,18,18,100.0,Boric
2021-12-05 05:24:46.923710,7047,194,False,1063,1035,627,454,62,375,775,4391,46,22,4459,30,30,100.0,Boric
2021-12-05 05:24:46.923710,7047,193,False,845,544,160,212,70,176,653,2660,10,11,2681,21,21,100.0,Boric
2021-12-05 05:24:46.923710,7047,192,False,1307,1173,548,610,65,411,770,4884,51,14,4949,30,30,100.0,Boric
2021-12-05 05:24:46.923710,7047,191,False,1023,1258,776,553,63,401,726,4800,54,43,4897,35,35,100.0,Kast
2021-12-05 05:24:46.923710,7047,190,False,833,517,173,247,52,176,788,2786,20,9,2815,21,21,100.0,Boric
2021-12-05 05:24:46.923710,7495,1494,False,17,26,11,7,2,13,15,91,2,2,95,1,1,100.0,Kast
2021-12-05 05:24:46.923710,7600,818,False,50,93,64,57,4,10,31,309,2,2,313,2,2,100.0,Kast
2021-12-05 05:24:46.923710,7352,960,False,240,405,59,48,20,69,541,1382,11,4,1397,15,15,100.0,Parisi
2021-12-05 05:24:46.923710,7352,961,False,129,153,27,29,6,24,240,608,6,2,616,8,8,100.0,Parisi
2021-12-05 05:24:46.923710,7352,962,False,303,504,236,99,28,118,417,1705,22,8,1735,16,16,100.0,Kast
2021-12-05 05:24:46.923710,7352,963,False,236,411,186,109,13,155,305,1415,16,12,1443,13,13,100.0,Kast
2021-12-05 05:24:46.923710,7352,964,False,212,288,190,74,4,88,206,1062,7,9,1078,10,10,100.0,Kast
2021-12-05 05:24:46.923710,7352,965,False,391,533,362,116,22,165,374,1963,39,16,2018,20,20,100.0,Kast
2021-12-05 05:24:46.923710,7352,966,False,237,378,181,114,11,111,274,1306,17,7,1330,12,12,100.0,Kast
2021-12-05 05:24:46.923710,7352,967,False,325,574,247,189,14,166,339,1854,19,5,1878,17,17,100.0,Kast
2021-12-05 05:24:46.923710,7352,968,False,275,400,217,96,9,121,297,1415,23,9,1447,13,13,100.0,Kast
2021-12-05 05:24:46.923710,7352,969,False,296,280,61,58,14,73,454,1236,6,4,1246,16,16,100.0,Parisi
2021-12-05 05:24:46.923710,7352,970,False,556,960,403,257,26,266,727,3195,30,12,3237,29,29,100.0,Kast
2021-12-05 05:24:46.923710,7352,971,False,472,804,270,117,37,183,762,2645,19,14,2678,25,25,100.0,Kast
2021-12-05 05:24:46.923710,7352,972,False,443,726,366,222,22,223,496,2498,34,17,2549,25,25,100.0,Kast
2021-12-05 05:24:46.923710,7352,973,False,184,316,185,82,13,94,214,1088,20,10,1118,10,10,100.0,Kast
2021-12-05 05:24:46.923710,7432,2618,False,539,509,485,142,18,119,289,2101,17,24,2142,17,17,100.0,Boric
2021-12-05 05:24:46.923710,7759,1471,False,84,215,95,61,6,51,75,587,6,9,602,4,4,100.0,Kast
2021-12-05 05:24:46.923710,7675,1432,False,78,243,101,82,6,26,94,630,9,8,647,4,4,100.0,Kast
2021-12-05 05:24:46.923710,7722,828,False,56,134,86,43,3,36,100,458,9,5,472,4,4,100.0,Kast
2021-12-05 05:24:46.923710,7536,668,False,220,220,156,98,10,157,291,1152,16,7,1175,8,8,100.0,Parisi
2021-12-05 05:24:46.923710,7487,1475,False,815,879,339,266,46,108,332,2785,21,7,2813,18,18,100.0,Kast
2021-12-05 05:24:46.923710,7487,1476,False,711,784,474,343,22,155,368,2857,19,9,2885,17,17,100.0,Kast
2021-12-05 05:24:46.923710,7487,1483,False,666,657,284,277,34,106,381,2405,23,7,2435,16,16,100.0,Boric
2021-12-05 05:24:46.923710,7487,1477,False,619,814,516,279,27,151,297,2703,30,18,2751,20,20,100.0,Kast
2021-12-05 05:24:46.923710,7487,1478,False,459,725,516,230,30,103,155,2218,21,18,2257,18,18,100.0,Kast
2021-12-05 05:24:46.923710,7487,1479,False,316,477,314,151,17,60,110,1445,14,11,1470,15,15,100.0,Kast
2021-12-05 05:24:46.923710,7487,1480,False,621,714,520,244,40,143,339,2621,23,22,2666,19,19,100.0,Kast
2021-12-05 05:24:46.923710,7487,1481,False,732,742,441,254,30,124,384,2707,20,16,2743,19,19,100.0,Kast
2021-12-05 05:24:46.923710,7487,1482,False,698,671,277,216,27,95,274,2258,26,7,2291,18,18,100.0,Boric
2021-12-05 05:24:46.923710,7684,2667,False,103,458,185,114,18,56,135,1069,10,6,1085,8,8,100.0,Kast
2021-12-05 05:24:46.923710,7757,1469,False,62,49,70,16,11,16,32,256,1,1,258,2,2,100.0,Provoste
2021-12-05 05:24:46.923710,7404,1201,False,348,859,205,212,17,106,422,2169,14,5,2188,17,17,100.0,Kast
2021-12-05 05:24:46.923710,7404,1202,False,304,1000,357,245,18,133,239,2296,24,13,2333,18,18,100.0,Kast
2021-12-05 05:24:46.923710,7404,1203,False,278,873,325,184,11,94,163,1928,27,24,1979,16,16,100.0,Kast
2021-12-05 05:24:46.923710,7118,496,False,51,140,68,63,1,19,42,384,4,4,392,3,3,100.0,Kast
2021-12-05 05:24:46.923710,7386,1123,False,265,1069,245,165,8,111,157,2020,16,11,2047,15,15,100.0,Kast
2021-12-05 05:24:46.923710,7386,1120,False,308,1087,168,148,20,85,258,2074,22,7,2103,16,16,100.0,Kast
2021-12-05 05:24:46.923710,7386,1121,False,157,841,168,121,10,71,94,1462,19,10,1491,13,13,100.0,Kast
2021-12-05 05:24:46.923710,7386,1122,False,202,971,227,134,16,69,109,1728,24,30,1782,16,16,100.0,Kast
2021-12-05 05:24:46.923710,7219,2425,False,984,687,241,362,38,192,276,2780,24,11,2815,15,15,100.0,Boric
2021-12-05 05:24:46.923710,7219,2424,False,997,1180,627,647,44,315,310,4120,25,18,4163,24,24,100.0,Kast
2021-12-05 05:24:46.923710,7219,2426,False,808,687,182,303,33,179,352,2544,15,7,2566,16,16,100.0,Boric
2021-12-05 05:24:46.923710,7219,2427,False,1086,1110,611,519,53,316,300,3995,32,39,4066,24,24,100.0,Kast
2021-12-05 05:24:46.923710,7472,1384,False,255,301,291,114,10,57,206,1234,11,16,1261,12,12,100.0,Kast
2021-12-05 05:24:46.923710,7377,1045,False,518,791,201,139,36,104,696,2485,28,23,2536,19,19,100.0,Kast
2021-12-05 05:24:46.923710,7377,1046,False,449,923,501,222,34,210,519,2858,43,17,2918,23,23,100.0,Kast
2021-12-05 05:24:46.923710,7377,1047,False,605,981,600,180,48,205,642,3261,47,54,3362,24,24,100.0,Kast
2021-12-05 05:24:46.923710,7377,1048,False,521,1066,590,242,32,229,631,3311,28,33,3372,24,24,100.0,Kast
2021-12-05 05:24:46.923710,7407,1207,False,299,610,165,188,23,66,155,1506,14,11,1531,13,13,100.0,Kast
2021-12-05 05:24:46.923710,7407,1208,False,249,621,168,153,28,59,115,1393,9,10,1412,12,12,100.0,Kast
2021-12-05 05:24:46.923710,7288,761,False,330,310,282,244,13,70,153,1402,21,13,1436,13,13,100.0,Boric
2021-12-05 05:24:46.923710,7288,762,False,417,369,324,219,14,64,146,1553,23,21,1597,14,14,100.0,Boric
2021-12-05 05:24:46.923710,7263,678,False,704,1013,546,451,40,275,399,3428,33,18,3479,22,22,100.0,Kast
2021-12-05 05:24:46.923710,7263,679,False,404,539,161,321,11,135,216,1787,6,2,1795,10,10,100.0,Kast
2021-12-05 05:24:46.923710,7263,692,False,579,928,439,505,24,223,238,2936,19,11,2966,22,22,100.0,Kast
2021-12-05 05:24:46.923710,7263,693,False,772,856,209,420,37,202,491,2987,20,7,3014,20,20,100.0,Kast
2021-12-05 05:24:46.923710,7263,680,False,516,380,88,191,32,111,319,1637,12,4,1653,11,11,100.0,Boric
2021-12-05 05:24:46.923710,7263,681,False,700,992,538,481,33,269,352,3365,25,25,3415,22,22,100.0,Kast
2021-12-05 05:24:46.923710,7263,682,False,907,1226,306,420,56,241,525,3681,27,11,3719,22,22,100.0,Kast
2021-12-05 05:24:46.923710,7263,683,False,658,1040,435,526,22,310,373,3364,20,9,3393,22,22,100.0,Kast
2021-12-05 05:24:46.923710,7263,684,False,814,1242,409,456,34,277,535,3767,29,11,3807,22,22,100.0,Kast
2021-12-05 05:24:46.923710,7263,685,False,856,738,235,365,38,203,553,2988,18,8,3014,20,20,100.0,Boric
2021-12-05 05:24:46.923710,7263,691,False,618,919,443,482,30,291,333,3116,30,7,3153,22,22,100.0,Kast
2021-12-05 05:24:46.923710,7263,686,False,660,914,510,416,39,262,284,3085,30,13,3128,22,22,100.0,Kast
2021-12-05 05:24:46.923710,7263,687,False,909,1353,561,676,35,357,445,4336,17,16,4369,27,27,100.0,Kast
2021-12-05 05:24:46.923710,7263,688,False,975,1434,562,792,45,399,568,4775,35,7,4817,27,27,100.0,Kast
2021-12-05 05:24:46.923710,7263,689,False,748,686,161,350,54,234,667,2900,13,12,2925,22,22,100.0,Boric
2021-12-05 05:24:46.923710,7263,690,False,664,1026,474,432,38,266,384,3284,27,21,3332,22,22,100.0,Kast
2021-12-05 05:24:46.923710,7677,2660,False,53,87,30,28,3,13,26,240,6,3,249,2,2,100.0,Kast
2021-12-05 05:24:46.923710,7471,1382,False,380,482,309,220,20,115,371,1897,25,12,1934,17,17,100.0,Kast
2021-12-05 05:24:46.923710,7471,1383,False,493,525,358,239,45,131,395,2186,19,23,2228,18,18,100.0,Kast
2021-12-05 05:24:46.923710,7345,938,False,300,589,282,140,13,101,302,1727,22,17,1766,14,14,100.0,Kast
2021-12-05 05:24:46.923710,7031,136,False,702,408,678,118,57,152,1124,3239,35,15,3289,34,34,100.0,Parisi
2021-12-05 05:24:46.923710,7039,162,False,43,46,260,6,3,6,65,429,4,2,435,4,4,100.0,Provoste
2021-12-05 05:24:46.923710,7243,605,False,684,674,282,398,26,242,473,2779,20,10,2809,19,19,100.0,Boric
2021-12-05 05:24:46.923710,7243,606,False,899,749,351,398,33,243,466,3139,27,19,3185,21,21,100.0,Boric
2021-12-05 05:24:46.923710,7667,822,False,145,318,200,164,8,122,151,1108,19,12,1139,10,10,100.0,Kast
2021-12-05 05:24:46.923710,7617,514,False,837,915,261,381,67,333,487,3281,30,6,3317,22,22,100.0,Kast
2021-12-05 05:24:46.923710,7617,518,False,528,505,108,192,44,140,224,1741,10,1,1752,8,8,100.0,Boric
2021-12-05 05:24:46.923710,7617,515,False,719,509,118,185,49,132,250,1962,15,4,1981,10,10,100.0,Boric
2021-12-05 05:24:46.923710,7617,516,False,1398,997,271,445,79,288,596,4074,37,7,4118,22,22,100.0,Boric
2021-12-05 05:24:46.923710,7617,517,False,1137,779,192,293,63,268,685,3417,33,8,3458,20,20,100.0,Boric
2021-12-05 05:24:46.923710,7319,2772,False,307,1190,460,303,14,104,217,2595,17,22,2634,20,20,100.0,Kast
2021-12-05 05:24:46.923710,7319,2773,False,260,1141,466,346,11,105,178,2507,12,15,2534,19,19,100.0,Kast
2021-12-05 05:24:46.923710,7128,1585,False,612,519,213,248,35,96,64,1787,16,3,1806,18,18,100.0,Boric
2021-12-05 05:24:46.923710,7128,1586,False,906,547,194,270,53,125,127,2222,10,6,2238,17,17,100.0,Boric
2021-12-05 05:24:46.923710,7128,1609,False,1131,347,150,222,79,69,81,2079,13,7,2099,16,16,100.0,Boric
2021-12-05 05:24:46.923710,7128,1587,False,812,342,117,205,44,85,64,1669,14,1,1684,16,16,100.0,Boric
2021-12-05 05:24:46.923710,7128,1610,False,1264,532,164,319,73,113,107,2572,9,8,2589,16,16,100.0,Boric
2021-12-05 05:24:46.923710,7128,1588,False,780,496,208,210,60,108,72,1934,8,6,1948,13,13,100.0,Boric
2021-12-05 05:24:46.923710,7128,1611,False,845,548,217,248,44,94,74,2070,14,9,2093,13,13,100.0,Boric
2021-12-05 05:24:46.923710,7128,1589,False,411,382,168,191,25,78,36,1291,8,5,1304,15,15,100.0,Boric
2021-12-05 05:24:46.923710,7128,1612,False,440,456,209,177,36,68,47,1433,11,7,1451,15,15,100.0,Kast
2021-12-05 05:24:46.923710,7128,1591,False,1020,421,145,236,80,133,195,2230,10,7,2247,22,22,100.0,Boric
2021-12-05 05:24:46.923710,7128,1592,False,509,349,120,208,48,77,79,1390,9,8,1407,19,19,100.0,Boric
2021-12-05 05:24:46.923710,7128,1593,False,350,372,110,185,24,115,60,1216,9,4,1229,19,19,100.0,Kast
2021-12-05 05:24:46.923710,7128,1613,False,394,334,114,172,20,85,62,1181,10,3,1194,19,19,100.0,Boric
2021-12-05 05:24:46.923710,7128,1590,False,754,658,260,279,46,101,63,2161,10,9,2180,17,17,100.0,Boric
2021-12-05 05:24:46.923710,7128,1606,False,210,155,35,73,17,44,32,566,3,5,574,9,9,100.0,Boric
2021-12-05 05:24:46.923710,7128,1607,False,425,468,148,276,44,78,47,1486,11,4,1501,17,17,100.0,Kast
2021-12-05 05:24:46.923710,7128,1608,False,498,495,167,230,27,84,44,1545,16,3,1564,17,17,100.0,Boric
2021-12-05 05:24:46.923710,7128,1594,False,323,429,136,177,27,45,40,1177,4,4,1185,15,15,100.0,Kast
2021-12-05 05:24:46.923710,7128,1614,False,405,430,183,210,22,69,31,1350,5,3,1358,15,15,100.0,Kast
2021-12-05 05:24:46.923710,7128,1595,False,981,840,317,424,48,173,107,2890,18,9,2917,24,24,100.0,Boric
2021-12-05 05:24:46.923710,7128,1596,False,1281,803,345,452,71,169,103,3224,28,7,3259,21,21,100.0,Boric
2021-12-05 05:24:46.923710,7128,1597,False,1520,802,379,456,73,167,100,3497,23,7,3527,20,20,100.0,Boric
2021-12-05 05:24:46.923710,7128,1598,False,894,519,163,265,74,127,132,2174,10,5,2189,21,21,100.0,Boric
2021-12-05 05:24:46.923710,7128,1599,False,880,430,125,196,62,116,167,1976,16,4,1996,21,21,100.0,Boric
2021-12-05 05:24:46.923710,7128,1600,False,410,409,118,240,19,60,31,1287,9,7,1303,17,17,100.0,Boric
2021-12-05 05:24:46.923710,7128,1601,False,478,454,184,266,26,76,41,1525,100,5,1630,17,17,100.0,Boric
2021-12-05 05:24:46.923710,7128,1605,False,866,669,260,398,44,153,120,2510,13,7,2530,21,21,100.0,Boric
2021-12-05 05:24:46.923710,7128,1604,False,609,644,195,298,43,128,74,1991,15,6,2012,21,21,100.0,Kast
2021-12-05 05:24:46.923710,7128,1602,False,845,418,186,215,43,90,53,1850,13,3,1866,19,19,100.0,Boric
2021-12-05 05:24:46.923710,7128,1603,False,984,456,180,278,60,100,92,2150,7,5,2162,19,19,100.0,Boric
2021-12-05 05:24:46.923710,7146,1719,False,755,478,235,288,36,289,173,2254,18,3,2275,17,17,100.0,Boric
2021-12-05 05:24:46.923710,7146,1720,False,675,452,254,290,45,296,201,2213,15,4,2232,17,17,100.0,Boric
2021-12-05 05:24:46.923710,7146,1721,False,729,420,231,269,32,288,256,2225,9,4,2238,17,17,100.0,Boric
2021-12-05 05:24:46.923710,7146,1728,False,1058,542,312,308,73,324,185,2802,22,5,2829,17,17,100.0,Boric
2021-12-05 05:24:46.923710,7146,1722,False,1225,797,358,323,102,390,317,3512,16,11,3539,24,24,100.0,Boric
2021-12-05 05:24:46.923710,7146,1723,False,539,423,233,249,33,242,131,1850,11,3,1864,19,19,100.0,Boric
2021-12-05 05:24:46.923710,7146,1724,False,1064,683,399,377,54,344,309,3230,23,15,3268,24,24,100.0,Boric
2021-12-05 05:24:46.923710,7146,1725,False,768,430,225,243,49,253,243,2211,17,8,2236,16,16,100.0,Boric
2021-12-05 05:24:46.923710,7146,1726,False,1214,640,378,311,95,369,313,3320,30,12,3362,24,24,100.0,Boric
2021-12-05 05:24:46.923710,7146,1727,False,838,631,402,358,56,376,215,2876,25,9,2910,24,24,100.0,Boric
2021-12-05 05:24:46.923710,7200,2230,False,513,2031,291,1374,19,39,33,4300,20,8,4328,20,20,100.0,Kast
2021-12-05 05:24:46.923710,7200,2219,False,406,2496,336,1452,5,63,27,4785,17,6,4808,24,24,100.0,Kast
2021-12-05 05:24:46.923710,7200,2220,False,624,2604,330,1672,14,50,39,5333,27,12,5372,24,24,100.0,Kast
2021-12-05 05:24:46.923710,7200,2228,False,447,2545,344,1517,10,44,27,4934,19,7,4960,22,22,100.0,Kast
2021-12-05 05:24:46.923710,7200,2229,False,610,2427,395,1747,9,47,22,5257,18,13,5288,22,22,100.0,Kast
2021-12-05 05:24:46.923710,7200,2227,False,603,2596,325,1508,14,49,40,5135,13,14,5162,24,24,100.0,Kast
2021-12-05 05:24:46.923710,7200,2216,False,451,2005,260,1157,14,41,19,3947,21,5,3973,18,18,100.0,Kast
2021-12-05 05:24:46.923710,7200,2217,False,463,1981,284,1267,10,41,36,4082,17,7,4106,18,18,100.0,Kast
2021-12-05 05:24:46.923710,7200,2221,False,224,1247,162,797,6,27,15,2478,5,1,2484,18,18,100.0,Kast
2021-12-05 05:24:46.923710,7200,2222,False,278,1565,207,975,6,24,15,3070,7,5,3082,18,18,100.0,Kast
2021-12-05 05:24:46.923710,7200,2223,False,395,1815,294,1299,7,43,19,3872,8,2,3882,16,16,100.0,Kast
2021-12-05 05:24:46.923710,7200,2218,False,720,1659,321,1393,10,48,43,4194,13,11,4218,18,18,100.0,Kast
2021-12-05 05:24:46.923710,7200,2231,False,688,1982,335,1563,11,46,43,4668,19,14,4701,18,18,100.0,Kast
2021-12-05 05:24:46.923710,7200,2224,False,337,1744,221,1010,15,31,27,3385,16,10,3411,18,18,100.0,Kast
2021-12-05 05:24:46.923710,7200,2225,False,462,1735,220,1126,14,40,36,3633,17,13,3663,18,18,100.0,Kast
2021-12-05 05:24:46.923710,7200,2226,False,423,1979,289,1223,9,55,29,4007,12,7,4026,22,22,100.0,Kast
2021-12-05 05:24:46.923710,7618,519,False,834,434,413,280,42,339,932,3274,19,20,3313,21,21,100.0,Parisi
2021-12-05 05:24:46.923710,7224,2457,False,582,438,186,198,29,169,260,1862,18,5,1885,11,11,100.0,Boric
2021-12-05 05:24:46.923710,7224,2452,False,802,453,173,198,44,221,514,2405,21,14,2440,17,17,100.0,Boric
2021-12-05 05:24:46.923710,7224,2453,False,559,568,378,264,38,202,236,2245,36,20,2301,14,14,100.0,Kast
2021-12-05 05:24:46.923710,7224,2454,False,673,619,363,247,36,239,393,2570,28,15,2613,15,15,100.0,Boric
2021-12-05 05:24:46.923710,7224,2455,False,450,520,358,264,28,224,194,2038,30,14,2082,13,13,100.0,Kast
2021-12-05 05:24:46.923710,7224,2456,False,530,532,306,287,29,234,293,2211,16,15,2242,13,13,100.0,Kast
2021-12-05 05:24:46.923710,7645,260,False,472,313,447,161,32,191,710,2326,25,17,2368,18,18,100.0,Parisi
2021-12-05 05:24:46.923710,7696,2566,False,1178,869,433,462,50,322,315,3629,25,11,3665,20,20,100.0,Boric
2021-12-05 05:24:46.923710,7097,345,False,937,307,114,138,74,164,386,2120,16,2,2138,15,15,100.0,Boric
2021-12-05 05:24:46.923710,7097,346,False,470,355,143,148,43,107,112,1378,9,4,1391,13,13,100.0,Boric
2021-12-05 05:24:46.923710,7097,347,False,842,568,244,257,56,226,219,2412,22,4,2438,15,15,100.0,Boric
2021-12-05 05:24:46.923710,7097,348,False,1311,1043,429,366,94,432,453,4128,41,16,4185,30,30,100.0,Boric
2021-12-05 05:24:46.923710,7097,349,False,808,424,102,133,65,177,437,2146,17,4,2167,20,20,100.0,Boric
2021-12-05 05:24:46.923710,7097,350,False,1774,1108,345,306,151,322,427,4433,35,8,4476,30,30,100.0,Boric
2021-12-05 05:24:46.923710,7097,351,False,1157,342,118,132,122,204,590,2665,30,4,2699,20,20,100.0,Boric
2021-12-05 05:24:46.923710,7097,357,False,901,740,434,260,67,255,175,2832,30,13,2875,25,25,100.0,Boric
2021-12-05 05:24:46.923710,7097,352,False,1062,400,179,230,69,147,161,2248,18,7,2273,12,12,100.0,Boric
2021-12-05 05:24:46.923710,7097,353,False,1052,368,144,154,102,128,301,2249,16,10,2275,20,20,100.0,Boric
2021-12-05 05:24:46.923710,7097,354,False,456,277,97,84,34,120,242,1310,9,0,1319,14,14,100.0,Boric
2021-12-05 05:24:46.923710,7097,355,False,914,392,135,129,90,243,482,2385,13,7,2405,20,20,100.0,Boric
2021-12-05 05:24:46.923710,7097,356,False,793,562,325,282,68,268,193,2491,31,11,2533,20,20,100.0,Boric
2021-12-05 05:24:46.923710,7097,366,False,670,431,232,211,54,182,185,1965,11,5,1981,15,15,100.0,Boric
2021-12-05 05:24:46.923710,7097,358,False,1113,780,349,325,97,266,259,3189,38,9,3236,25,25,100.0,Boric
2021-12-05 05:24:46.923710,7097,359,False,797,639,303,214,75,187,192,2407,22,16,2445,25,25,100.0,Boric
2021-12-05 05:24:46.923710,7097,360,False,945,759,405,266,64,301,264,3004,43,19,3066,25,25,100.0,Boric
2021-12-05 05:24:46.923710,7097,361,False,1098,911,410,450,68,350,262,3549,43,15,3607,30,30,100.0,Boric
2021-12-05 05:24:46.923710,7097,362,False,1315,868,449,407,82,420,355,3896,35,8,3939,30,30,100.0,Boric
2021-12-05 05:24:46.923710,7097,363,False,1197,847,454,287,75,386,345,3591,24,24,3639,25,25,100.0,Boric
2021-12-05 05:24:46.923710,7097,364,False,639,573,261,221,52,183,166,2095,17,8,2120,18,18,100.0,Boric
2021-12-05 05:24:46.923710,7097,365,False,828,244,99,110,88,183,474,2026,9,6,2041,15,15,100.0,Boric
2021-12-05 05:24:46.923710,7121,502,False,895,846,347,458,56,292,276,3170,17,7,3194,18,18,100.0,Boric
2021-12-05 05:24:46.923710,7121,503,False,1511,1181,468,564,67,371,431,4593,27,12,4632,25,25,100.0,Boric
2021-12-05 05:24:46.923710,7032,137,False,383,153,309,74,16,92,362,1389,11,5,1405,11,11,100.0,Boric
2021-12-05 05:24:46.923710,7120,500,False,1053,947,461,479,63,396,278,3677,17,13,3707,20,20,100.0,Boric
2021-12-05 05:24:46.923710,7120,501,False,1171,844,379,320,78,363,257,3412,21,5,3438,17,17,100.0,Boric
2021-12-05 05:24:46.923710,7721,677,False,550,453,381,317,30,153,249,2133,13,11,2157,14,14,100.0,Boric
2021-12-05 05:24:46.923710,7043,166,False,124,119,513,35,2,22,171,986,4,5,995,10,10,100.0,Provoste
2021-12-05 05:24:46.923710,7283,752,False,123,855,235,194,6,94,300,1807,17,11,1835,15,15,100.0,Kast
2021-12-05 05:24:46.923710,7586,1422,False,143,274,89,96,3,25,76,706,3,6,715,4,4,100.0,Kast
2021-12-05 05:24:46.923710,7387,1124,False,198,656,139,98,22,89,72,1274,15,9,1298,12,12,100.0,Kast
2021-12-05 05:24:46.923710,7387,1125,False,226,565,139,83,25,72,82,1192,17,7,1216,13,13,100.0,Kast
2021-12-05 05:24:46.923710,7693,674,False,106,183,109,75,7,57,78,615,11,7,633,3,3,100.0,Kast
2021-12-05 05:24:46.923710,7166,1912,False,748,359,266,167,75,304,264,2183,15,6,2204,16,16,100.0,Boric
2021-12-05 05:24:46.923710,7166,1911,False,846,560,368,278,75,506,413,3046,21,14,3081,24,24,100.0,Boric
2021-12-05 05:24:46.923710,7166,1916,False,739,355,283,174,59,335,290,2235,20,8,2263,17,17,100.0,Boric
2021-12-05 05:24:46.923710,7166,1913,False,596,398,333,173,47,393,224,2164,18,20,2202,17,17,100.0,Boric
2021-12-05 05:24:46.923710,7166,1914,False,740,406,345,202,44,376,258,2371,17,11,2399,17,17,100.0,Boric
2021-12-05 05:24:46.923710,7166,1915,False,1017,469,338,275,76,537,395,3107,25,18,3150,21,21,100.0,Boric
2021-12-05 05:24:46.923710,7166,1917,False,628,413,305,243,47,433,237,2306,23,9,2338,20,20,100.0,Boric
2021-12-05 05:24:46.923710,7189,2118,False,1695,1002,411,763,54,136,73,4134,16,10,4160,20,20,100.0,Boric
2021-12-05 05:24:46.923710,7189,2119,False,2022,959,411,844,77,134,79,4526,25,9,4560,20,20,100.0,Boric
2021-12-05 05:24:46.923710,7189,2121,False,1640,1011,387,630,62,140,95,3965,16,6,3987,20,20,100.0,Boric
2021-12-05 05:24:46.923710,7189,2120,False,1064,651,275,430,42,95,59,2616,11,2,2629,12,12,100.0,Boric
2021-12-05 05:24:46.923710,7189,2123,False,964,734,262,540,39,131,89,2759,14,8,2781,16,16,100.0,Boric
2021-12-05 05:24:46.923710,7189,2124,False,1128,774,295,569,56,149,92,3063,16,1,3080,16,16,100.0,Boric
2021-12-05 05:24:46.923710,7189,2125,False,1015,703,315,549,37,148,88,2855,13,6,2874,16,16,100.0,Boric
2021-12-05 05:24:46.923710,7189,2126,False,1550,888,386,736,58,173,80,3871,14,7,3892,19,19,100.0,Boric
2021-12-05 05:24:46.923710,7189,2122,False,2078,1159,429,798,74,134,117,4789,18,16,4823,22,22,100.0,Boric
2021-12-05 05:24:46.923710,7189,2116,False,1177,934,340,659,52,136,82,3380,18,4,3402,18,18,100.0,Boric
2021-12-05 05:24:46.923710,7189,2117,False,1501,915,363,605,57,179,115,3735,30,5,3770,18,18,100.0,Boric
2021-12-05 05:24:46.923710,7346,939,False,323,680,393,274,26,152,322,2170,36,26,2232,16,16,100.0,Kast
2021-12-05 05:24:46.923710,7346,940,False,243,590,318,258,23,118,278,1828,15,7,1850,13,13,100.0,Kast
2021-12-05 05:24:46.923710,7679,2662,False,53,165,80,41,1,32,70,442,5,7,454,4,4,100.0,Kast
2021-12-05 05:24:46.923710,7108,434,False,1689,1039,461,470,106,355,473,4593,30,20,4643,24,24,100.0,Boric
2021-12-05 05:24:46.923710,7108,435,False,1572,1043,532,520,77,440,554,4738,42,17,4797,28,28,100.0,Boric
2021-12-05 05:24:46.923710,7108,436,False,856,791,325,403,41,246,272,2934,23,5,2962,19,19,100.0,Boric
2021-12-05 05:24:46.923710,7108,437,False,660,509,300,262,49,204,256,2240,26,4,2270,14,14,100.0,Boric
2021-12-05 05:24:46.923710,7108,438,False,1155,779,294,427,55,238,305,3253,6,9,3268,17,17,100.0,Boric
2021-12-05 05:24:46.923710,7108,439,False,1545,1149,483,608,88,467,621,4961,41,10,5012,30,30,100.0,Boric
2021-12-05 05:24:46.923710,7410,1225,False,236,649,250,158,6,100,191,1590,16,16,1622,11,11,100.0,Kast
2021-12-05 05:24:46.923710,7410,1226,False,275,748,374,187,28,114,173,1899,30,21,1950,17,17,100.0,Kast
2021-12-05 05:24:46.923710,7410,1227,False,171,585,258,137,16,76,138,1381,15,7,1403,14,14,100.0,Kast
2021-12-05 05:24:46.923710,7410,1228,False,275,617,237,125,16,94,198,1562,18,11,1591,12,12,100.0,Kast
2021-12-05 05:24:46.923710,7040,163,False,425,305,1168,135,22,69,512,2636,17,12,2665,18,18,100.0,Provoste
2021-12-05 05:24:46.923710,7462,1359,False,159,494,239,109,4,47,100,1152,14,17,1183,10,10,100.0,Kast
2021-12-05 05:24:46.923710,7462,1358,False,578,1350,718,294,33,135,337,3445,44,43,3532,27,27,100.0,Kast
2021-12-05 05:24:46.923710,7464,1364,False,500,1290,517,238,28,139,461,3173,18,28,3219,19,19,100.0,Kast
2021-12-05 05:24:46.923710,7464,1363,False,768,1733,690,477,28,186,655,4537,32,29,4598,28,28,100.0,Kast
2021-12-05 05:24:46.923710,7735,1301,False,643,1091,267,340,48,193,470,3052,18,12,3082,16,16,100.0,Kast
2021-12-05 05:24:46.923710,7735,1302,False,673,1021,283,347,45,172,439,2980,17,8,3005,15,15,100.0,Kast
2021-12-05 05:24:46.923710,7485,1401,False,208,435,155,150,15,34,60,1057,8,14,1079,12,12,100.0,Kast
2021-12-05 05:24:46.923710,7430,2615,False,369,1036,313,239,26,83,310,2376,29,16,2421,17,17,100.0,Kast
2021-12-05 05:24:46.923710,7430,2616,False,370,1008,308,281,29,95,288,2379,11,8,2398,17,17,100.0,Kast
2021-12-05 05:24:46.923710,7424,1261,False,515,951,608,186,39,205,236,2740,46,36,2822,20,20,100.0,Kast
2021-12-05 05:24:46.923710,7424,1262,False,365,851,526,178,34,171,237,2362,22,23,2407,17,17,100.0,Kast
2021-12-05 05:24:46.923710,7697,2807,False,45,77,58,35,1,25,77,318,2,1,321,2,2,100.0,Kast
2021-12-05 05:24:46.923710,7006,2700,False,24,140,39,26,5,26,239,499,7,7,513,6,6,100.0,Parisi
2021-12-05 05:24:46.923710,7413,1234,False,156,725,192,183,10,53,113,1432,9,10,1451,12,12,100.0,Kast
2021-12-05 05:24:46.923710,7413,1235,False,199,740,231,197,5,69,139,1580,17,11,1608,12,12,100.0,Kast
2021-12-05 05:24:46.923710,7413,1236,False,324,1015,284,243,20,77,273,2236,19,14,2269,16,16,100.0,Kast
2021-12-05 05:24:46.923710,7228,555,False,1096,703,267,322,48,272,740,3448,37,9,3494,22,22,100.0,Boric
2021-12-05 05:24:46.923710,7228,556,False,613,472,229,212,24,216,404,2170,22,15,2207,13,13,100.0,Boric
2021-12-05 05:24:46.923710,7228,557,False,1164,893,576,487,45,443,623,4231,58,22,4311,24,24,100.0,Boric
2021-12-05 05:24:46.923710,7228,558,False,851,823,445,458,36,417,471,3501,49,19,3569,21,21,100.0,Boric
2021-12-05 05:24:46.923710,7496,1495,False,129,150,80,43,4,18,68,492,2,5,499,6,6,100.0,Kast
2021-12-05 05:24:46.923710,7289,763,False,54,126,76,76,4,18,25,379,5,2,386,3,3,100.0,Kast
2021-12-05 05:24:46.923710,7641,2804,False,26,263,59,55,2,17,58,480,5,4,489,3,3,100.0,Kast
2021-12-05 05:24:46.923710,7621,671,False,377,444,218,226,15,146,416,1842,20,14,1876,11,11,100.0,Kast
2021-12-05 05:24:46.923710,7094,335,False,621,812,400,328,29,280,844,3314,35,18,3367,21,21,100.0,Parisi
2021-12-05 05:24:46.923710,7094,336,False,833,913,362,450,30,364,1050,4002,37,16,4055,25,25,100.0,Parisi
2021-12-05 05:24:46.923710,7483,1399,False,410,526,308,183,35,114,423,1999,29,31,2059,16,16,100.0,Kast
2021-12-05 05:24:46.923710,7585,1421,False,33,120,69,52,3,16,68,361,6,15,382,3,3,100.0,Kast
2021-12-05 05:24:46.923710,7271,709,False,317,407,380,312,13,120,144,1693,15,7,1715,13,13,100.0,Kast
2021-12-05 05:24:46.923710,7271,710,False,415,423,462,243,25,112,191,1871,17,19,1907,15,15,100.0,Provoste
2021-12-05 05:24:46.923710,7341,909,False,625,705,296,225,47,218,639,2755,16,4,2775,18,18,100.0,Kast
2021-12-05 05:24:46.923710,7341,910,False,476,767,341,278,26,294,560,2742,23,14,2779,20,20,100.0,Kast
2021-12-05 05:24:46.923710,7341,911,False,750,903,365,346,59,334,720,3477,14,7,3498,20,20,100.0,Kast
2021-12-05 05:24:46.923710,7341,912,False,731,898,341,279,33,203,658,3143,15,11,3169,18,18,100.0,Kast
2021-12-05 05:24:46.923710,7341,913,False,564,674,295,287,30,275,493,2618,18,6,2642,14,14,100.0,Kast
2021-12-05 05:24:46.923710,7341,914,False,280,374,167,162,19,127,366,1495,9,2,1506,9,9,100.0,Kast
2021-12-05 05:24:46.923710,7341,915,False,738,870,457,322,35,288,817,3527,33,16,3576,22,22,100.0,Kast
2021-12-05 05:24:46.923710,7341,916,False,281,386,242,150,30,165,327,1581,12,8,1601,11,11,100.0,Kast
2021-12-05 05:24:46.923710,7341,917,False,642,680,368,239,35,226,612,2802,28,7,2837,18,18,100.0,Kast
2021-12-05 05:24:46.923710,7341,918,False,444,641,320,208,24,196,503,2336,18,8,2362,14,14,100.0,Kast
2021-12-05 05:24:46.923710,7341,919,False,870,979,431,442,65,369,1148,4304,33,11,4348,27,27,100.0,Parisi
2021-12-05 05:24:46.923710,7341,920,False,391,579,254,203,30,180,519,2156,22,7,2185,15,15,100.0,Kast
2021-12-05 05:24:46.923710,7341,921,False,745,673,345,238,44,252,792,3089,25,10,3124,18,18,100.0,Parisi
2021-12-05 05:24:46.923710,7341,922,False,647,837,376,339,46,294,680,3219,24,5,3248,20,20,100.0,Kast
2021-12-05 05:24:46.923710,7558,1267,False,285,795,377,313,23,101,218,2112,47,42,2201,16,16,100.0,Kast
2021-12-05 05:24:46.923710,7348,942,False,284,456,230,163,10,190,364,1697,22,5,1724,11,11,100.0,Kast
2021-12-05 05:24:46.923710,7348,943,False,294,546,244,191,34,184,416,1909,26,30,1965,15,15,100.0,Kast
2021-12-05 05:24:46.923710,7348,944,False,236,436,224,206,11,169,247,1529,13,10,1552,12,12,100.0,Kast
2021-12-05 05:24:46.923710,7348,945,False,470,556,207,179,36,196,581,2225,19,14,2258,16,16,100.0,Parisi
2021-12-05 05:24:46.923710,7290,764,False,86,257,160,91,4,39,61,698,7,5,710,6,6,100.0,Kast
2021-12-05 05:24:46.923710,7009,25,False,65,116,25,16,4,16,212,454,3,2,459,10,10,100.0,Parisi
2021-12-05 05:24:46.923710,7009,24,False,82,156,49,35,3,26,233,584,7,9,600,20,20,100.0,Parisi
2021-12-05 05:24:46.923710,7041,164,False,641,538,1309,196,58,193,930,3865,33,15,3913,25,25,100.0,Provoste
2021-12-05 05:24:46.923710,7148,1729,False,673,427,420,311,62,373,219,2485,22,25,2532,16,16,100.0,Boric
2021-12-05 05:24:46.923710,7148,1730,False,727,472,384,299,56,389,268,2595,27,17,2639,16,16,100.0,Boric
2021-12-05 05:24:46.923710,7148,1731,False,817,468,320,277,62,333,346,2623,28,15,2666,16,16,100.0,Boric
2021-12-05 05:24:46.923710,7148,1733,False,1106,730,308,461,96,347,435,3483,26,10,3519,22,22,100.0,Boric
2021-12-05 05:24:46.923710,7148,1734,False,881,544,404,382,56,454,310,3031,46,19,3096,20,20,100.0,Boric
2021-12-05 05:24:46.923710,7148,1735,False,778,534,369,386,70,417,290,2844,39,12,2895,20,20,100.0,Boric
2021-12-05 05:24:46.923710,7148,1732,False,679,461,264,307,68,277,200,2256,13,9,2278,13,13,100.0,Boric
2021-12-05 05:24:46.923710,7148,1736,False,825,470,329,318,59,432,323,2756,19,10,2785,18,18,100.0,Boric
2021-12-05 05:24:46.923710,7148,1737,False,512,267,194,187,59,239,174,1632,11,6,1649,10,10,100.0,Boric
2021-12-05 05:24:46.923710,7687,1433,False,100,283,89,97,5,57,86,717,7,11,735,7,7,100.0,Kast
2021-12-05 05:24:46.923710,7590,2475,False,570,808,279,323,18,195,254,2447,25,24,2496,13,13,100.0,Kast
2021-12-05 05:24:46.923710,7644,1284,False,63,188,59,33,3,33,58,437,5,3,445,3,3,100.0,Kast
2021-12-05 05:24:46.923710,7301,803,False,24,81,32,17,0,13,12,179,4,0,183,2,2,100.0,Kast
2021-12-05 05:24:46.923710,7695,2565,False,607,620,221,329,48,187,336,2348,21,10,2379,13,13,100.0,Kast
2021-12-05 05:24:46.923710,7566,1414,False,53,166,93,56,4,21,48,441,4,6,451,4,4,100.0,Kast
2021-12-05 05:24:46.923710,7568,1268,False,119,325,136,76,3,49,59,767,10,3,780,7,7,100.0,Kast
2021-12-05 05:24:46.923710,7057,225,False,86,146,92,50,9,41,79,503,11,7,521,6,6,100.0,Kast
2021-12-05 05:24:46.923710,7650,1285,False,68,130,87,21,11,19,82,418,26,26,470,4,4,100.0,Kast
2021-12-05 05:24:46.923710,7742,2672,False,109,349,193,84,9,31,102,877,20,12,909,6,6,100.0,Kast
2021-12-05 05:24:46.923710,7064,240,False,725,463,482,293,38,191,656,2848,18,18,2884,18,18,100.0,Boric
2021-12-05 05:24:46.923710,7064,239,False,803,440,655,243,28,197,629,2995,19,17,3031,21,21,100.0,Boric
2021-12-05 05:24:46.923710,7064,238,False,670,446,346,211,38,127,569,2407,16,10,2433,15,15,100.0,Boric
2021-12-05 05:24:46.923710,7064,237,False,605,426,515,238,23,171,488,2466,20,20,2506,18,18,100.0,Boric
2021-12-05 05:24:46.923710,7064,236,False,343,178,106,76,23,60,396,1182,9,5,1196,10,10,100.0,Parisi
2021-12-05 05:24:46.923710,7273,712,False,116,205,98,103,6,37,58,623,2,1,626,5,5,100.0,Kast
2021-12-05 05:24:46.923710,7134,1647,False,788,573,195,251,64,153,136,2160,16,6,2182,13,13,100.0,Boric
2021-12-05 05:24:46.923710,7134,1648,False,876,614,222,344,62,233,204,2555,15,6,2576,17,17,100.0,Boric
2021-12-05 05:24:46.923710,7134,1649,False,902,556,226,354,67,192,239,2536,20,8,2564,17,17,100.0,Boric
2021-12-05 05:24:46.923710,7134,1650,False,953,659,323,452,59,284,158,2888,32,14,2934,21,21,100.0,Boric
2021-12-05 05:24:46.923710,7134,1651,False,1267,792,367,502,74,270,184,3456,18,16,3490,24,24,100.0,Boric
2021-12-05 05:24:46.923710,7134,1652,False,1097,735,328,394,83,232,184,3053,18,12,3083,21,21,100.0,Boric
2021-12-05 05:24:46.923710,7134,1653,False,1103,752,252,310,75,236,207,2935,12,13,2960,21,21,100.0,Boric
2021-12-05 05:24:46.923710,7134,1654,False,756,666,252,370,44,194,132,2414,13,1,2428,24,24,100.0,Boric
2021-12-05 05:24:46.923710,7134,1655,False,1076,889,330,543,45,291,201,3375,15,7,3397,24,24,100.0,Boric
2021-12-05 05:24:46.923710,7134,1656,False,912,764,327,401,58,272,151,2885,16,7,2908,20,20,100.0,Boric
2021-12-05 05:24:46.923710,7134,1657,False,1125,698,301,349,73,249,176,2971,22,3,2996,20,20,100.0,Boric
2021-12-05 05:24:46.923710,7134,1658,False,714,629,291,376,45,196,104,2355,11,4,2370,24,24,100.0,Boric
2021-12-05 05:24:46.923710,7007,1,False,413,656,123,124,29,104,438,1887,16,4,1907,17,17,100.0,Kast
2021-12-05 05:24:46.923710,7007,21,False,317,403,79,79,29,70,372,1349,9,5,1363,15,15,100.0,Kast
2021-12-05 05:24:46.923710,7007,3,False,587,826,241,258,25,197,743,2877,20,10,2907,26,26,100.0,Kast
2021-12-05 05:24:46.923710,7007,14,False,441,893,196,201,39,153,507,2430,23,6,2459,25,25,100.0,Kast
2021-12-05 05:24:46.923710,7007,4,False,608,874,298,200,45,184,618,2827,26,10,2863,25,25,100.0,Kast
2021-12-05 05:24:46.923710,7007,9,False,701,765,273,179,46,192,695,2851,22,17,2890,25,25,100.0,Kast
2021-12-05 05:24:46.923710,7007,16,False,630,786,224,174,56,175,739,2784,19,9,2812,25,25,100.0,Kast
2021-12-05 05:24:46.923710,7007,5,False,569,891,239,220,31,184,666,2800,20,5,2825,25,25,100.0,Kast
2021-12-05 05:24:46.923710,7007,15,False,210,340,93,98,11,53,187,992,3,6,1001,10,10,100.0,Kast
2021-12-05 05:24:46.923710,7007,22,False,250,383,73,78,21,67,313,1185,17,5,1207,15,15,100.0,Kast
2021-12-05 05:24:46.923710,7007,20,False,303,535,190,140,23,119,342,1652,16,6,1674,15,15,100.0,Kast
2021-12-05 05:24:46.923710,7007,7,False,197,347,94,95,12,97,267,1109,15,2,1126,10,10,100.0,Kast
2021-12-05 05:24:46.923710,7007,10,False,228,287,121,81,17,71,274,1079,10,5,1094,10,10,100.0,Kast
2021-12-05 05:24:46.923710,7007,8,False,313,503,159,164,22,112,342,1615,9,5,1629,15,15,100.0,Kast
2021-12-05 05:24:46.923710,7007,19,False,601,883,246,265,22,221,613,2851,22,7,2880,25,25,100.0,Kast
2021-12-05 05:24:46.923710,7007,6,False,394,719,174,215,31,181,463,2177,17,8,2202,20,20,100.0,Kast
2021-12-05 05:24:46.923710,7007,2,False,581,847,210,217,35,166,812,2868,23,9,2900,26,26,100.0,Kast
2021-12-05 05:24:46.923710,7007,23,False,432,833,250,225,28,148,455,2371,8,11,2390,25,25,100.0,Kast
2021-12-05 05:24:46.923710,7007,17,False,718,939,239,286,35,204,556,2977,18,5,3000,26,26,100.0,Kast
2021-12-05 05:24:46.923710,7007,12,False,450,812,239,249,24,167,351,2292,27,8,2327,25,25,100.0,Kast
2021-12-05 05:24:46.923710,7007,13,False,286,560,144,133,16,99,309,1547,18,9,1574,17,17,100.0,Kast
2021-12-05 05:24:46.923710,7007,11,False,598,855,209,259,47,196,731,2895,21,6,2922,26,26,100.0,Kast
2021-12-05 05:24:46.923710,7007,18,False,576,956,180,185,48,159,588,2692,21,10,2723,25,25,100.0,Kast
2021-12-05 05:24:46.923710,7715,53,False,474,766,152,233,28,123,414,2190,17,3,2210,13,13,100.0,Kast
2021-12-05 05:24:46.923710,7715,51,False,648,1103,234,327,36,170,557,3075,17,8,3100,20,20,100.0,Kast
2021-12-05 05:24:46.923710,7715,49,False,458,697,176,229,13,123,485,2181,17,6,2204,13,13,100.0,Kast
2021-12-05 05:24:46.923710,7715,52,False,713,1142,216,306,43,202,592,3214,20,6,3240,20,20,100.0,Kast
2021-12-05 05:24:46.923710,7715,47,False,587,875,181,283,33,133,452,2544,31,6,2581,15,15,100.0,Kast
2021-12-05 05:24:46.923710,7715,48,False,716,1137,254,368,40,208,626,3349,17,5,3371,20,20,100.0,Kast
2021-12-05 05:24:46.923710,7715,54,False,615,980,176,273,42,141,427,2654,9,12,2675,15,15,100.0,Kast
2021-12-05 05:24:46.923710,7715,50,False,903,1474,318,425,47,249,764,4180,26,14,4220,25,25,100.0,Kast
2021-12-05 05:24:46.923710,7225,2460,False,1213,916,302,464,71,289,483,3738,22,16,3776,21,21,100.0,Boric
2021-12-05 05:24:46.923710,7225,2461,False,520,665,410,321,24,302,208,2450,17,22,2489,16,16,100.0,Kast
2021-12-05 05:24:46.923710,7225,2462,False,663,719,330,377,34,290,337,2750,24,9,2783,16,16,100.0,Kast
2021-12-05 05:24:46.923710,7225,2458,False,485,586,458,266,32,269,186,2282,19,15,2316,15,15,100.0,Kast
2021-12-05 05:24:46.923710,7225,2459,False,585,752,327,305,38,217,291,2515,16,8,2539,15,15,100.0,Kast
2021-12-05 05:24:46.923710,7124,508,False,972,581,352,314,41,323,311,2894,60,73,3027,19,19,100.0,Boric
2021-12-05 05:24:46.923710,7676,2659,False,39,47,34,6,4,15,21,166,2,0,168,1,1,100.0,Kast
2021-12-05 05:24:46.923710,7459,1352,False,36,96,45,52,6,13,28,276,1,6,283,2,2,100.0,Kast
2021-12-05 05:24:46.923710,7581,1418,False,23,71,27,42,3,30,31,227,4,13,244,3,3,100.0,Kast
2021-12-05 05:24:46.923710,7375,1038,False,1,63,28,10,1,10,1,114,6,4,124,1,1,100.0,Kast
2021-12-05 05:24:46.923710,7573,1417,False,30,127,21,25,7,27,50,287,6,12,305,4,4,100.0,Kast
2021-12-05 05:24:46.923710,7353,974,False,42,201,66,33,3,33,34,412,11,7,430,4,4,100.0,Kast
2021-12-05 05:24:46.923710,7619,2520,False,1032,508,203,352,61,217,285,2658,12,4,2674,17,17,100.0,Boric
2021-12-05 05:24:46.923710,7619,2521,False,1224,519,234,355,66,245,266,2909,24,5,2938,17,17,100.0,Boric
2021-12-05 05:24:46.923710,7619,2522,False,845,335,152,237,43,101,109,1822,18,5,1845,10,10,100.0,Boric
2021-12-05 05:24:46.923710,7619,2523,False,703,351,133,256,29,94,95,1661,16,3,1680,8,8,100.0,Boric
2021-12-05 05:24:46.923710,7619,2526,False,1039,325,161,280,57,142,147,2151,16,2,2169,10,10,100.0,Boric
2021-12-05 05:24:46.923710,7619,2524,False,1178,645,289,469,52,190,149,2972,15,7,2994,15,15,100.0,Boric
2021-12-05 05:24:46.923710,7619,2525,False,796,542,223,364,37,212,140,2314,9,4,2327,15,15,100.0,Boric
2021-12-05 05:24:46.923710,7116,483,False,144,61,37,42,5,22,6,317,1,3,321,3,3,100.0,Boric
2021-12-05 05:24:46.923710,7164,1898,False,663,434,168,174,38,136,121,1734,12,3,1749,10,10,100.0,Boric
2021-12-05 05:24:46.923710,7164,1899,False,769,765,303,484,59,252,136,2768,25,5,2798,23,23,100.0,Boric
2021-12-05 05:24:46.923710,7164,1900,False,1619,1034,457,583,107,356,229,4385,31,7,4423,24,24,100.0,Boric
2021-12-05 05:24:46.923710,7164,1901,False,1187,723,301,397,65,257,202,3132,18,9,3159,20,20,100.0,Boric
2021-12-05 05:24:46.923710,7164,1902,False,860,793,324,464,46,249,185,2921,21,4,2946,20,20,100.0,Boric
2021-12-05 05:24:46.923710,7164,1903,False,1009,769,341,448,55,291,194,3107,18,9,3134,20,20,100.0,Boric
2021-12-05 05:24:46.923710,7164,1906,False,1281,975,448,510,53,333,270,3870,29,11,3910,24,24,100.0,Boric
2021-12-05 05:24:46.923710,7164,1904,False,980,706,269,435,58,249,224,2921,16,7,2944,20,20,100.0,Boric
2021-12-05 05:24:46.923710,7164,1905,False,1067,769,368,499,43,286,150,3182,32,1,3215,19,19,100.0,Boric
2021-12-05 05:24:46.923710,7164,1907,False,866,705,273,428,47,257,242,2818,32,3,2853,20,20,100.0,Boric
2021-12-05 05:24:46.923710,7164,1908,False,989,715,239,406,61,241,269,2920,24,4,2948,19,19,100.0,Boric
2021-12-05 05:24:46.923710,7164,1909,False,865,624,256,305,60,210,153,2473,18,9,2500,16,16,100.0,Boric
2021-12-05 05:24:46.923710,7164,1910,False,893,818,354,444,41,293,186,3029,32,6,3067,24,24,100.0,Boric
2021-12-05 05:24:46.923710,7091,321,False,397,486,187,236,20,134,278,1738,13,7,1758,10,10,100.0,Kast
2021-12-05 05:24:46.923710,7091,322,False,572,862,301,437,20,235,481,2908,13,5,2926,16,16,100.0,Kast
2021-12-05 05:24:46.923710,7091,323,False,603,697,166,330,38,139,483,2456,10,5,2471,12,12,100.0,Kast
2021-12-05 05:24:46.923710,7091,324,False,552,594,154,246,22,138,374,2080,17,0,2097,11,11,100.0,Kast
2021-12-05 05:24:46.923710,7259,652,False,191,251,167,130,12,52,57,860,8,14,882,8,8,100.0,Kast
2021-12-05 05:24:46.923710,7259,653,False,215,263,159,171,7,61,71,947,4,10,961,7,7,100.0,Kast
2021-12-05 05:24:46.923710,7172,1951,False,1442,648,530,467,100,540,395,4122,31,6,4159,24,24,100.0,Boric
2021-12-05 05:24:46.923710,7172,1952,False,617,363,331,209,35,240,185,1980,20,12,2012,14,14,100.0,Boric
2021-12-05 05:24:46.923710,7172,1957,False,850,528,379,343,58,390,254,2802,21,5,2828,20,20,100.0,Boric
2021-12-05 05:24:46.923710,7172,1953,False,1308,455,174,215,86,359,660,3257,22,6,3285,24,24,100.0,Boric
2021-12-05 05:24:46.923710,7172,1958,False,807,572,346,298,67,360,260,2710,19,2,2731,20,20,100.0,Boric
2021-12-05 05:24:46.923710,7172,1954,False,673,320,231,119,46,174,178,1741,7,4,1752,10,10,100.0,Boric
2021-12-05 05:24:46.923710,7172,1960,False,860,560,486,356,51,382,243,2938,27,10,2975,24,24,100.0,Boric
2021-12-05 05:24:46.923710,7172,1955,False,709,257,95,129,48,166,266,1670,10,7,1687,13,13,100.0,Boric
2021-12-05 05:24:46.923710,7172,1961,False,1006,566,398,271,72,354,301,2968,17,10,2995,18,18,100.0,Boric
2021-12-05 05:24:46.923710,7172,1956,False,470,291,291,177,37,216,130,1612,17,5,1634,14,14,100.0,Boric
2021-12-05 05:24:46.923710,7172,1959,False,627,267,151,139,50,200,237,1671,12,3,1686,14,14,100.0,Boric
2021-12-05 05:24:46.923710,7172,1962,False,715,476,311,286,42,300,186,2316,27,10,2353,18,18,100.0,Boric
2021-12-05 05:24:46.923710,7172,1963,False,803,437,375,244,55,349,218,2481,20,8,2509,17,17,100.0,Boric
2021-12-05 05:24:46.923710,7172,1964,False,862,452,333,221,64,327,250,2509,21,7,2537,17,17,100.0,Boric
2021-12-05 05:24:46.923710,7172,1965,False,792,505,431,270,49,332,242,2621,24,12,2657,19,19,100.0,Boric
2021-12-05 05:24:46.923710,7172,1966,False,836,533,482,324,52,355,221,2803,27,13,2843,19,19,100.0,Boric
2021-12-05 05:24:46.923710,7172,1967,False,769,443,275,229,47,322,257,2342,14,7,2363,17,17,100.0,Boric
2021-12-05 05:24:46.923710,7172,1968,False,741,432,292,258,43,286,259,2311,31,5,2347,16,16,100.0,Boric
2021-12-05 05:24:46.923710,7046,187,False,459,322,296,109,30,116,406,1738,23,26,1787,14,14,100.0,Boric
2021-12-05 05:24:46.923710,7567,817,False,85,162,175,105,2,27,31,587,5,4,596,4,4,100.0,Provoste
2021-12-05 05:24:46.923710,7552,1503,False,93,309,86,98,3,19,33,641,3,8,652,5,5,100.0,Kast
2021-12-05 05:24:46.923710,7368,1024,False,351,911,357,318,21,222,691,2871,40,18,2929,22,22,100.0,Kast
2021-12-05 05:24:46.923710,7368,1025,False,248,481,139,141,16,126,405,1556,16,9,1581,10,10,100.0,Kast
2021-12-05 05:24:46.923710,7368,1026,False,371,674,187,176,29,125,627,2189,18,14,2221,16,16,100.0,Kast
2021-12-05 05:24:46.923710,7368,1027,False,329,644,330,245,17,159,572,2296,44,23,2363,17,17,100.0,Kast
2021-12-05 05:24:46.923710,7072,261,False,737,360,115,167,40,114,529,2062,16,7,2085,15,15,100.0,Boric
2021-12-05 05:24:46.923710,7072,262,False,1153,867,433,444,55,253,599,3804,24,14,3842,22,22,100.0,Boric
2021-12-05 05:24:46.923710,7072,263,False,1064,855,683,399,44,312,549,3906,37,26,3969,25,25,100.0,Boric
2021-12-05 05:24:46.923710,7072,264,False,1055,891,582,548,51,348,469,3944,29,9,3982,25,25,100.0,Boric
2021-12-05 05:24:46.923710,7737,1466,False,33,240,95,32,2,18,62,482,3,10,495,4,4,100.0,Kast
2021-12-05 05:24:46.923710,7754,1303,False,113,281,113,68,11,40,71,697,11,19,727,5,5,100.0,Kast
2021-12-05 05:24:46.923710,7174,1971,False,689,480,505,252,50,498,224,2698,51,18,2767,24,24,100.0,Boric
2021-12-05 05:24:46.923710,7174,1973,False,627,285,143,119,66,225,403,1868,19,5,1892,23,23,100.0,Boric
2021-12-05 05:24:46.923710,7174,1974,False,729,405,478,209,58,423,232,2534,31,21,2586,24,24,100.0,Boric
2021-12-05 05:24:46.923710,7174,1982,False,734,489,551,216,50,488,229,2757,41,32,2830,24,24,100.0,Boric
2021-12-05 05:24:46.923710,7174,1977,False,704,275,143,103,51,280,365,1921,19,2,1942,24,24,100.0,Boric
2021-12-05 05:24:46.923710,7174,1978,False,628,329,464,190,39,346,209,2205,39,30,2274,22,22,100.0,Boric
2021-12-05 05:24:46.923710,7174,1972,False,522,340,351,167,52,334,194,1960,22,12,1994,19,19,100.0,Boric
2021-12-05 05:24:46.923710,7174,1985,False,589,387,307,160,50,368,231,2092,27,13,2132,19,19,100.0,Boric
2021-12-05 05:24:46.923710,7174,1979,False,618,439,378,246,43,477,231,2432,23,6,2461,22,22,100.0,Boric
2021-12-05 05:24:46.923710,7174,1981,False,593,367,332,227,44,375,223,2161,16,14,2191,20,20,100.0,Boric
2021-12-05 05:24:46.923710,7174,1984,False,624,379,343,232,49,429,216,2272,24,10,2306,20,20,100.0,Boric
2021-12-05 05:24:46.923710,7174,1975,False,848,428,344,205,73,412,266,2576,19,8,2603,20,20,100.0,Boric
2021-12-05 05:24:46.923710,7174,1976,False,690,268,120,94,53,201,295,1721,10,4,1735,24,24,100.0,Boric
2021-12-05 05:24:46.923710,7174,1969,False,690,441,251,174,55,322,368,2301,14,5,2320,23,23,100.0,Boric
2021-12-05 05:24:46.923710,7174,1970,False,566,406,176,136,43,325,403,2055,14,7,2076,24,24,100.0,Boric
2021-12-05 05:24:46.923710,7174,1980,False,519,307,132,112,38,242,346,1696,8,5,1709,21,21,100.0,Boric
2021-12-05 05:24:46.923710,7174,1983,False,623,423,429,298,34,496,226,2529,28,11,2568,23,23,100.0,Boric
2021-12-05 05:24:46.923710,7703,675,False,282,262,118,140,10,77,140,1029,8,5,1042,6,6,100.0,Boric
2021-12-05 05:24:46.923710,7196,2176,False,751,1149,367,764,39,93,59,3222,9,11,3242,19,19,100.0,Kast
2021-12-05 05:24:46.923710,7196,2174,False,1128,974,332,803,47,122,123,3529,25,10,3564,18,18,100.0,Boric
2021-12-05 05:24:46.923710,7196,2175,False,741,866,313,734,23,112,49,2838,19,9,2866,18,18,100.0,Kast
2021-12-05 05:24:46.923710,7196,2177,False,1103,1385,476,1009,36,100,62,4171,22,9,4202,19,19,100.0,Kast
2021-12-05 05:24:46.923710,7196,2178,False,1067,1114,406,830,46,132,88,3683,22,9,3714,18,18,100.0,Kast
2021-12-05 05:24:46.923710,7196,2179,False,1647,1339,564,1372,39,126,74,5161,32,5,5198,22,22,100.0,Boric
2021-12-05 05:24:46.923710,7196,2180,False,779,884,287,650,30,52,56,2738,9,10,2757,12,12,100.0,Kast
2021-12-05 05:24:46.923710,7196,2181,False,1221,1201,540,1112,33,147,72,4326,21,8,4355,21,21,100.0,Boric
2021-12-05 05:24:46.923710,7196,2182,False,1411,1471,570,1213,46,110,64,4885,23,12,4920,21,21,100.0,Kast
2021-12-05 05:24:46.923710,7196,2183,False,908,927,366,744,34,129,90,3198,17,10,3225,16,16,100.0,Kast
2021-12-05 05:24:46.923710,7196,2184,False,718,1050,402,758,41,110,65,3144,21,8,3173,18,18,100.0,Kast
2021-12-05 05:24:46.923710,7196,2185,False,902,1146,407,866,31,126,87,3565,15,11,3591,18,18,100.0,Kast
2021-12-05 05:24:46.923710,7196,2186,False,545,664,229,515,23,45,50,2071,6,9,2086,10,10,100.0,Kast
2021-12-05 05:24:46.923710,7196,2187,False,807,984,357,778,34,121,74,3155,16,8,3179,18,18,100.0,Kast
2021-12-05 05:24:46.923710,7196,2188,False,846,894,296,744,31,111,118,3040,17,13,3070,17,17,100.0,Kast
2021-12-05 05:24:46.923710,7196,2189,False,1147,988,381,835,41,143,91,3626,16,8,3650,18,18,100.0,Boric
2021-12-05 05:24:46.923710,7044,186,False,802,1000,499,506,35,258,451,3551,31,20,3602,25,25,100.0,Kast
2021-12-05 05:24:46.923710,7044,185,False,1586,1464,450,652,92,234,654,5132,33,13,5178,30,30,100.0,Boric
2021-12-05 05:24:46.923710,7044,184,False,1225,1201,534,636,50,353,722,4721,19,12,4752,28,28,100.0,Boric
2021-12-05 05:24:46.923710,7044,183,False,579,852,380,450,24,161,236,2682,30,11,2723,19,19,100.0,Kast
2021-12-05 05:24:46.923710,7044,182,False,1333,967,297,431,85,277,631,4021,29,10,4060,25,25,100.0,Boric
2021-12-05 05:24:46.923710,7044,181,False,1287,1208,346,556,72,218,584,4271,21,11,4303,25,25,100.0,Boric
2021-12-05 05:24:46.923710,7044,180,False,914,945,479,549,40,295,509,3731,23,7,3761,24,24,100.0,Kast
2021-12-05 05:24:46.923710,7044,179,False,1496,934,310,505,64,190,593,4092,17,7,4116,20,20,100.0,Boric
2021-12-05 05:24:46.923710,7044,178,False,866,1135,485,530,37,206,414,3673,24,18,3715,25,25,100.0,Kast
2021-12-05 05:24:46.923710,7044,177,False,1154,1079,443,467,57,243,519,3962,25,9,3996,22,22,100.0,Boric
2021-12-05 05:24:46.923710,7044,176,False,1279,1358,527,686,47,292,593,4782,32,13,4827,25,25,100.0,Kast
2021-12-05 05:24:46.923710,7044,175,False,1393,1337,471,736,61,258,498,4754,20,8,4782,25,25,100.0,Boric
2021-12-05 05:24:46.923710,7044,174,False,1483,1176,678,589,76,294,758,5054,34,29,5117,33,33,100.0,Boric
2021-12-05 05:24:46.923710,7044,173,False,1443,1340,769,625,71,407,736,5391,32,21,5444,34,34,100.0,Boric
2021-12-05 05:24:46.923710,7044,172,False,1001,841,402,399,55,216,575,3489,20,5,3514,20,20,100.0,Boric
2021-12-05 05:24:46.923710,7044,171,False,975,956,465,559,41,270,529,3795,23,10,3828,25,25,100.0,Boric
2021-12-05 05:24:46.923710,7489,1485,False,31,75,30,20,3,5,16,180,3,0,183,2,2,100.0,Kast
2021-12-05 05:24:46.923710,7716,55,False,158,187,138,51,18,71,239,862,9,6,877,6,6,100.0,Parisi
2021-12-05 05:24:46.923710,7437,2628,False,544,1045,359,271,28,117,463,2827,14,22,2863,19,19,100.0,Kast
2021-12-05 05:24:46.923710,7437,2629,False,354,675,186,170,18,93,293,1789,9,8,1806,12,12,100.0,Kast
2021-12-05 05:24:46.923710,7437,2630,False,153,339,147,112,5,45,97,898,5,5,908,6,6,100.0,Kast
2021-12-05 05:24:46.923710,7437,2631,False,342,617,271,191,20,71,268,1780,10,9,1799,12,12,100.0,Kast
2021-12-05 05:24:46.923710,7437,2632,False,270,708,274,262,15,82,190,1801,16,14,1831,14,14,100.0,Kast
2021-12-05 05:24:46.923710,7437,2633,False,275,588,196,170,17,86,212,1544,10,6,1560,9,9,100.0,Kast
2021-12-05 05:24:46.923710,7437,2634,False,226,495,187,188,18,91,223,1428,8,13,1449,9,9,100.0,Kast
2021-12-05 05:24:46.923710,7437,2635,False,269,576,244,190,19,80,205,1583,16,13,1612,11,11,100.0,Kast
2021-12-05 05:24:46.923710,7437,2636,False,293,663,338,210,19,78,220,1821,19,11,1851,14,14,100.0,Kast
2021-12-05 05:24:46.923710,7688,1434,False,225,350,86,97,16,84,240,1098,7,5,1110,7,7,100.0,Kast
2021-12-05 05:24:46.923710,7630,1280,False,422,919,322,230,31,185,338,2447,29,12,2488,13,13,100.0,Kast
2021-12-05 05:24:46.923710,7630,1281,False,582,763,218,246,26,190,581,2606,24,8,2638,13,13,100.0,Kast
2021-12-05 05:24:46.923710,7441,2647,False,281,460,182,134,16,64,177,1314,25,9,1348,13,13,100.0,Kast
2021-12-05 05:24:46.923710,7441,2648,False,189,399,144,128,13,50,130,1053,7,15,1075,10,10,100.0,Kast
2021-12-05 05:24:46.923710,7245,609,False,362,721,369,331,31,174,162,2150,18,22,2190,17,17,100.0,Kast
2021-12-05 05:24:46.923710,7490,1486,False,23,118,21,16,6,4,0,188,4,5,197,2,2,100.0,Kast
2021-12-05 05:24:46.923710,7508,1550,False,57,134,33,24,3,26,25,302,2,2,306,3,3,100.0,Kast
2021-12-05 05:24:46.923710,7646,521,False,501,276,141,121,39,174,158,1410,9,7,1426,8,8,100.0,Boric
2021-12-05 05:24:46.923710,7626,1071,False,438,629,233,142,31,174,540,2187,17,6,2210,13,13,100.0,Kast
2021-12-05 05:24:46.923710,7626,1075,False,730,950,378,214,38,242,914,3466,43,12,3521,22,22,100.0,Kast
2021-12-05 05:24:46.923710,7626,1072,False,689,731,292,188,51,220,666,2837,27,8,2872,16,16,100.0,Kast
2021-12-05 05:24:46.923710,7626,1073,False,544,692,268,166,39,212,636,2557,17,3,2577,15,15,100.0,Kast
2021-12-05 05:24:46.923710,7626,1074,False,765,683,197,181,55,179,762,2822,12,3,2837,17,17,100.0,Boric
2021-12-05 05:24:46.923710,7626,1076,False,749,981,363,232,40,280,1036,3681,35,5,3721,23,23,100.0,Parisi
2021-12-05 05:24:46.923710,7126,1573,False,467,601,320,304,27,260,245,2224,28,13,2265,16,16,100.0,Kast
2021-12-05 05:24:46.923710,7126,1574,False,522,670,304,354,36,340,296,2522,23,14,2559,16,16,100.0,Kast
2021-12-05 05:24:46.923710,7126,1581,False,239,156,41,81,13,82,104,716,6,1,723,6,6,100.0,Boric
2021-12-05 05:24:46.923710,7126,1575,False,516,455,148,255,47,223,361,2005,12,2,2019,15,15,100.0,Boric
2021-12-05 05:24:46.923710,7126,1576,False,398,528,286,235,23,239,178,1887,20,24,1931,14,14,100.0,Kast
2021-12-05 05:24:46.923710,7126,1577,False,414,542,264,220,34,247,243,1964,17,15,1996,14,14,100.0,Kast
2021-12-05 05:24:46.923710,7126,1578,False,570,657,264,303,34,288,243,2359,15,8,2382,15,15,100.0,Kast
2021-12-05 05:24:46.923710,7126,1579,False,510,593,152,221,37,265,313,2091,12,9,2112,15,15,100.0,Kast
2021-12-05 05:24:46.923710,7126,1580,False,549,516,103,201,32,229,444,2074,10,3,2087,17,17,100.0,Boric
2021-12-05 05:24:46.923710,7428,2608,False,337,493,208,129,29,61,200,1457,15,14,1486,13,13,100.0,Kast
2021-12-05 05:24:46.923710,7428,2609,False,436,689,234,146,20,89,335,1949,14,16,1979,13,13,100.0,Kast
2021-12-05 05:24:46.923710,7428,2610,False,328,634,251,164,19,62,215,1673,13,14,1700,14,14,100.0,Kast
2021-12-05 05:24:46.923710,7656,1083,False,244,539,271,123,19,107,518,1821,21,17,1859,10,10,100.0,Kast
2021-12-05 05:24:46.923710,7142,1705,False,1094,492,389,266,87,332,237,2897,29,19,2945,24,24,100.0,Boric
2021-12-05 05:24:46.923710,7142,1700,False,539,393,232,222,42,239,100,1767,158,6,1931,17,17,100.0,Boric
2021-12-05 05:24:46.923710,7142,1701,False,676,462,226,284,41,292,216,2197,21,5,2223,17,17,100.0,Boric
2021-12-05 05:24:46.923710,7142,1703,False,800,401,251,252,59,269,232,2264,18,12,2294,17,17,100.0,Boric
2021-12-05 05:24:46.923710,7142,1704,False,756,404,251,239,44,323,146,2163,22,22,2207,18,18,100.0,Boric
2021-12-05 05:24:46.923710,7142,1706,False,782,413,238,162,60,257,171,2083,20,7,2110,16,16,100.0,Boric
2021-12-05 05:24:46.923710,7142,1702,False,633,349,242,200,40,249,153,1866,13,14,1893,14,14,100.0,Boric
2021-12-05 05:24:46.923710,7142,1707,False,737,355,242,237,40,294,139,2044,16,4,2064,15,15,100.0,Boric
2021-12-05 05:24:46.923710,7142,1699,False,923,668,437,357,58,473,200,3116,42,16,3174,24,24,100.0,Boric
2021-12-05 05:24:46.923710,7686,2671,False,447,216,82,112,22,48,124,1051,11,1,1063,5,5,100.0,Boric
2021-12-05 05:24:46.923710,7686,2669,False,656,692,372,243,35,174,387,2559,22,6,2587,15,15,100.0,Kast
2021-12-05 05:24:46.923710,7686,2670,False,274,230,114,104,12,60,131,925,9,2,936,5,5,100.0,Boric
2021-12-05 05:24:46.923710,7244,607,False,799,785,616,431,42,292,308,3273,38,44,3355,23,23,100.0,Boric
2021-12-05 05:24:46.923710,7244,608,False,832,886,486,520,31,313,365,3433,39,31,3503,25,25,100.0,Kast
2021-12-05 05:24:46.923710,7649,1081,False,114,336,192,87,9,75,170,983,16,17,1016,6,6,100.0,Kast
2021-12-05 05:24:46.923710,7598,1423,False,69,141,82,33,8,33,97,463,3,2,468,3,3,100.0,Kast
2021-12-05 05:24:46.923710,7602,259,False,1031,538,299,240,84,282,1126,3600,29,5,3634,27,27,100.0,Parisi
2021-12-05 05:24:46.923710,7602,258,False,601,450,260,215,38,273,841,2678,8,10,2696,23,23,100.0,Parisi
2021-12-05 05:24:46.923710,7602,257,False,957,630,535,337,59,335,633,3486,31,16,3533,23,23,100.0,Boric
2021-12-05 05:24:46.923710,7602,256,False,813,470,201,188,59,283,1386,3400,28,8,3436,27,27,100.0,Parisi
2021-12-05 05:24:46.923710,7602,255,False,898,416,214,178,71,217,775,2769,23,12,2804,19,19,100.0,Boric
2021-12-05 05:24:46.923710,7635,1431,False,70,304,86,65,8,13,87,633,1,6,640,4,4,100.0,Kast
2021-12-05 05:24:46.923710,7414,1237,False,77,482,101,117,5,16,93,891,8,8,907,7,7,100.0,Kast
2021-12-05 05:24:46.923710,7400,1188,False,215,867,298,186,18,87,158,1829,21,18,1868,14,14,100.0,Kast
2021-12-05 05:24:46.923710,7400,1189,False,309,856,314,168,18,97,208,1970,24,11,2005,13,13,100.0,Kast
2021-12-05 05:24:46.923710,7400,1190,False,322,1152,370,242,22,123,275,2506,26,5,2537,14,14,100.0,Kast
2021-12-05 05:24:46.923710,7400,1191,False,207,849,237,176,16,108,220,1813,21,11,1845,12,12,100.0,Kast
2021-12-05 05:24:46.923710,7400,1192,False,293,990,274,129,18,101,275,2080,27,9,2116,13,13,100.0,Kast
2021-12-05 05:24:46.923710,7400,1194,False,350,818,171,122,25,100,336,1922,12,8,1942,14,14,100.0,Kast
2021-12-05 05:24:46.923710,7400,1193,False,264,878,369,140,22,99,218,1990,27,21,2038,15,15,100.0,Kast
2021-12-05 05:24:46.923710,7374,1035,False,420,1087,414,206,24,210,304,2665,28,25,2718,21,21,100.0,Kast
2021-12-05 05:24:46.923710,7374,1036,False,509,1152,472,173,42,210,387,2945,43,24,3012,21,21,100.0,Kast
2021-12-05 05:24:46.923710,7374,1037,False,597,1014,381,115,26,183,474,2790,31,15,2836,21,21,100.0,Kast
2021-12-05 05:24:46.923710,7690,1436,False,190,344,146,106,16,76,183,1061,19,30,1110,8,8,100.0,Kast
2021-12-05 05:24:46.923710,7569,1269,False,410,935,127,206,37,90,153,1958,8,13,1979,11,11,100.0,Kast
2021-12-05 05:24:46.923710,7272,711,False,446,530,441,525,23,150,289,2404,13,11,2428,19,19,100.0,Kast
2021-12-05 05:24:46.923710,7095,337,False,1307,1070,257,431,78,225,609,3977,28,12,4017,23,23,100.0,Boric
2021-12-05 05:24:46.923710,7095,338,False,1247,1390,415,682,72,332,667,4805,45,16,4866,28,28,100.0,Kast
2021-12-05 05:24:46.923710,7095,339,False,766,961,353,444,35,244,308,3111,30,17,3158,21,21,100.0,Kast
2021-12-05 05:24:46.923710,7095,340,False,951,1121,450,448,43,275,409,3697,38,21,3756,24,24,100.0,Kast
2021-12-05 05:24:46.923710,7095,341,False,972,1193,316,413,52,219,562,3727,29,13,3769,21,21,100.0,Kast
2021-12-05 05:24:46.923710,7291,765,False,555,963,283,327,27,160,458,2773,24,15,2812,17,17,100.0,Kast
2021-12-05 05:24:46.923710,7291,766,False,706,1204,511,380,28,236,378,3443,22,16,3481,23,23,100.0,Kast
2021-12-05 05:24:46.923710,7291,767,False,513,498,110,183,26,97,419,1846,17,5,1868,13,13,100.0,Boric
2021-12-05 05:24:46.923710,7291,768,False,843,1427,471,581,25,272,491,4110,42,18,4170,23,23,100.0,Kast
2021-12-05 05:24:46.923710,7291,769,False,937,1201,281,442,45,231,508,3645,31,14,3690,22,22,100.0,Kast
2021-12-05 05:24:46.923710,7291,770,False,935,1347,271,386,39,170,635,3783,17,14,3814,23,23,100.0,Kast
2021-12-05 05:24:46.923710,7291,771,False,606,1194,457,462,30,256,334,3339,31,12,3382,25,25,100.0,Kast
2021-12-05 05:24:46.923710,7291,772,False,823,1397,457,508,24,275,450,3934,35,14,3983,26,26,100.0,Kast
2021-12-05 05:24:46.923710,7291,773,False,697,1260,376,451,24,255,451,3514,18,11,3543,24,24,100.0,Kast
2021-12-05 05:24:46.923710,7291,774,False,639,930,369,332,24,176,422,2892,20,18,2930,20,20,100.0,Kast
2021-12-05 05:24:46.923710,7291,775,False,641,1153,551,441,26,249,367,3428,31,20,3479,25,25,100.0,Kast
2021-12-05 05:24:46.923710,7435,2626,False,82,351,116,106,15,55,97,822,17,25,864,8,8,100.0,Kast
2021-12-05 05:24:46.923710,7640,1080,False,297,378,265,114,32,137,430,1653,18,6,1677,10,10,100.0,Parisi
2021-12-05 05:24:46.923710,7258,650,False,247,395,296,229,9,89,70,1335,8,8,1351,9,9,100.0,Kast
2021-12-05 05:24:46.923710,7258,651,False,426,540,319,241,22,111,138,1797,18,20,1835,13,13,100.0,Kast
2021-12-05 05:24:46.923710,7672,1288,False,22,189,85,40,2,18,39,395,8,21,424,3,3,100.0,Kast
2021-12-05 05:24:46.923710,7457,1347,False,16,134,15,22,0,8,5,200,4,6,210,2,2,100.0,Kast
2021-12-05 05:24:46.923710,7463,1360,False,743,1371,605,273,40,258,763,4053,36,40,4129,25,25,100.0,Kast
2021-12-05 05:24:46.923710,7463,1362,False,411,689,295,197,17,151,381,2141,16,11,2168,12,12,100.0,Kast
2021-12-05 05:24:46.923710,7463,1361,False,241,558,290,157,9,139,246,1640,11,19,1670,11,11,100.0,Kast
2021-12-05 05:24:46.923710,7087,304,False,1237,717,741,380,73,397,850,4395,72,27,4494,26,26,100.0,Boric
2021-12-05 05:24:46.923710,7087,305,False,524,223,106,119,32,108,493,1605,8,9,1622,11,11,100.0,Boric
2021-12-05 05:24:46.923710,7087,306,False,1139,748,594,507,64,469,717,4238,45,13,4296,25,25,100.0,Boric
2021-12-05 05:24:46.923710,7587,1063,False,51,69,33,22,3,20,37,235,2,5,242,2,2,100.0,Kast
2021-12-05 05:24:46.923710,7537,815,False,145,372,179,322,10,32,62,1122,5,13,1140,7,7,100.0,Kast
2021-12-05 05:24:46.923710,7431,2617,False,147,361,120,86,10,31,97,852,6,10,868,6,6,100.0,Kast
2021-12-05 05:24:46.923710,7691,1437,False,32,178,71,50,2,7,17,357,2,7,366,3,3,100.0,Kast
2021-12-05 05:24:46.923710,7206,2271,False,373,3466,235,1890,20,56,81,6121,13,14,6148,24,24,100.0,Kast
2021-12-05 05:24:46.923710,7206,2282,False,340,1320,88,1052,9,69,126,3004,6,2,3012,14,14,100.0,Kast
2021-12-05 05:24:46.923710,7206,2272,False,222,2277,169,1281,7,42,49,4047,8,7,4062,17,17,100.0,Kast
2021-12-05 05:24:46.923710,7206,2273,False,246,2449,146,1353,8,24,36,4262,11,4,4277,17,17,100.0,Kast
2021-12-05 05:24:46.923710,7206,2274,False,388,1313,247,710,18,175,92,2943,15,11,2969,16,16,100.0,Kast
2021-12-05 05:24:46.923710,7206,2275,False,427,1419,171,876,23,150,131,3197,14,7,3218,17,17,100.0,Kast
2021-12-05 05:24:46.923710,7206,2278,False,261,2187,147,1308,5,59,64,4031,6,9,4046,22,22,100.0,Kast
2021-12-05 05:24:46.923710,7206,2279,False,385,2556,164,1663,20,57,88,4933,26,12,4971,22,22,100.0,Kast
2021-12-05 05:24:46.923710,7206,2276,False,265,2418,143,1428,19,61,43,4377,8,4,4389,17,17,100.0,Kast
2021-12-05 05:24:46.923710,7206,2277,False,266,2521,161,1607,7,56,46,4664,16,2,4682,18,18,100.0,Kast
2021-12-05 05:24:46.923710,7206,2280,False,514,1997,414,1047,27,201,132,4332,20,15,4367,23,23,100.0,Kast
2021-12-05 05:24:46.923710,7206,2281,False,527,2343,263,1226,24,157,144,4684,13,7,4704,22,22,100.0,Kast
2021-12-05 05:24:46.923710,7206,2283,False,403,2043,222,1203,13,142,157,4183,8,8,4199,19,19,100.0,Kast
2021-12-05 05:24:46.923710,7766,2576,False,637,672,284,284,38,266,252,2433,28,16,2477,14,14,100.0,Kast
2021-12-05 05:24:46.923710,7515,659,False,356,298,207,119,22,119,249,1370,13,12,1395,10,10,100.0,Boric
2021-12-05 05:24:46.923710,7515,660,False,354,254,169,170,12,156,252,1367,9,5,1381,9,9,100.0,Boric
2021-12-05 05:24:46.923710,7144,1708,False,591,316,182,185,33,193,131,1631,11,4,1646,11,11,100.0,Boric
2021-12-05 05:24:46.923710,7144,1709,False,562,326,200,202,40,230,137,1697,14,3,1714,12,12,100.0,Boric
2021-12-05 05:24:46.923710,7144,1710,False,718,410,224,284,55,265,173,2129,24,10,2163,15,15,100.0,Boric
2021-12-05 05:24:46.923710,7144,1711,False,913,618,363,310,44,378,299,2925,20,10,2955,20,20,100.0,Boric
2021-12-05 05:24:46.923710,7144,1712,False,1125,569,348,338,73,397,263,3113,20,12,3145,20,20,100.0,Boric
2021-12-05 05:24:46.923710,7144,1713,False,812,417,265,216,58,243,179,2190,13,14,2217,17,17,100.0,Boric
2021-12-05 05:24:46.923710,7144,1714,False,874,545,242,233,68,266,233,2461,20,11,2492,17,17,100.0,Boric
2021-12-05 05:24:46.923710,7144,1715,False,631,506,247,245,39,290,226,2184,16,3,2203,15,15,100.0,Boric
2021-12-05 05:24:46.923710,7144,1716,False,797,662,324,337,58,380,225,2783,31,20,2834,22,22,100.0,Boric
2021-12-05 05:24:46.923710,7144,1717,False,1099,629,278,389,72,411,403,3281,34,18,3333,22,22,100.0,Boric
2021-12-05 05:24:46.923710,7144,1718,False,632,493,273,252,41,314,174,2179,21,15,2215,17,17,100.0,Boric
2021-12-05 05:24:46.923710,7158,1837,False,858,598,343,351,51,412,259,2872,14,15,2901,20,20,100.0,Boric
2021-12-05 05:24:46.923710,7158,1843,False,1319,674,409,339,92,496,387,3716,22,7,3745,24,24,100.0,Boric
2021-12-05 05:24:46.923710,7158,1839,False,744,531,350,319,53,398,196,2591,27,15,2633,20,20,100.0,Boric
2021-12-05 05:24:46.923710,7158,1848,False,701,328,148,162,72,218,265,1894,18,10,1922,15,15,100.0,Boric
2021-12-05 05:24:46.923710,7158,1840,False,802,535,414,362,42,367,212,2734,36,18,2788,21,21,100.0,Boric
2021-12-05 05:24:46.923710,7158,1841,False,670,385,211,227,44,295,238,2070,12,4,2086,14,14,100.0,Boric
2021-12-05 05:24:46.923710,7158,1850,False,658,334,205,269,47,269,234,2016,14,6,2036,14,14,100.0,Boric
2021-12-05 05:24:46.923710,7158,1842,False,1216,640,393,382,91,504,424,3650,23,15,3688,24,24,100.0,Boric
2021-12-05 05:24:46.923710,7158,1849,False,784,452,229,188,67,227,217,2164,16,14,2194,13,13,100.0,Boric
2021-12-05 05:24:46.923710,7158,1845,False,1112,583,377,336,70,421,300,3199,20,16,3235,22,22,100.0,Boric
2021-12-05 05:24:46.923710,7158,1846,False,958,657,501,350,59,429,241,3195,20,12,3227,21,21,100.0,Boric
2021-12-05 05:24:46.923710,7158,1847,False,843,603,343,342,60,407,266,2864,172,9,3045,20,20,100.0,Boric
2021-12-05 05:24:46.923710,7158,1844,False,976,628,492,342,78,424,311,3251,26,19,3296,22,22,100.0,Boric
2021-12-05 05:24:46.923710,7158,1838,False,1282,606,370,420,84,405,328,3495,29,6,3530,22,22,100.0,Boric
2021-12-05 05:24:46.923710,7167,1919,False,1138,446,332,217,91,373,301,2898,25,17,2940,24,24,100.0,Boric
2021-12-05 05:24:46.923710,7167,1922,False,596,385,215,157,45,250,176,1824,15,5,1844,20,20,100.0,Boric
2021-12-05 05:24:46.923710,7167,1921,False,813,384,181,196,40,272,326,2212,21,3,2236,20,20,100.0,Boric
2021-12-05 05:24:46.923710,7167,1923,False,654,421,295,203,48,335,212,2168,20,10,2198,20,20,100.0,Boric
2021-12-05 05:24:46.923710,7167,1924,False,828,384,267,208,60,364,296,2407,15,11,2433,20,20,100.0,Boric
2021-12-05 05:24:46.923710,7167,1926,False,430,206,181,82,22,151,111,1183,11,11,1205,11,11,100.0,Boric
2021-12-05 05:24:46.923710,7167,1918,False,802,290,193,162,71,333,316,2167,14,7,2188,18,18,100.0,Boric
2021-12-05 05:24:46.923710,7167,1920,False,1067,471,316,207,73,326,209,2669,11,4,2684,19,19,100.0,Boric
2021-12-05 05:24:46.923710,7167,1925,False,906,436,364,289,50,402,268,2715,27,10,2752,21,21,100.0,Boric
2021-12-05 05:24:46.923710,7252,638,False,314,434,340,267,8,63,128,1554,8,22,1584,11,11,100.0,Kast
2021-12-05 05:24:46.923710,7252,639,False,254,378,314,302,10,57,100,1415,10,17,1442,10,10,100.0,Kast
2021-12-05 05:24:46.923710,7627,1077,False,1328,1526,358,514,55,307,1070,5158,26,11,5195,27,27,100.0,Kast
2021-12-05 05:24:46.923710,7627,1078,False,544,788,328,262,22,158,418,2520,19,9,2548,15,15,100.0,Kast
2021-12-05 05:24:46.923710,7415,1238,False,310,724,331,205,17,115,310,2012,18,10,2040,14,14,100.0,Kast
2021-12-05 05:24:46.923710,7415,1240,False,279,701,364,200,15,132,259,1950,14,26,1990,17,17,100.0,Kast
2021-12-05 05:24:46.923710,7415,1241,False,446,846,316,208,26,140,418,2400,23,9,2432,18,18,100.0,Kast
2021-12-05 05:24:46.923710,7415,1239,False,249,624,277,181,21,112,189,1653,11,7,1671,15,15,100.0,Kast
2021-12-05 05:24:46.923710,7294,782,False,706,1456,444,388,25,180,507,3706,24,16,3746,27,27,100.0,Kast
2021-12-05 05:24:46.923710,7294,783,False,445,1360,496,427,11,159,309,3207,28,17,3252,26,26,100.0,Kast
2021-12-05 05:24:46.923710,7294,784,False,493,1366,474,371,20,179,261,3164,35,33,3232,26,26,100.0,Kast
2021-12-05 05:24:46.923710,7385,1117,False,139,602,212,82,4,42,82,1163,13,19,1195,11,11,100.0,Kast
2021-12-05 05:24:46.923710,7385,1118,False,182,490,194,65,4,39,125,1099,17,8,1124,10,10,100.0,Kast
2021-12-05 05:24:46.923710,7385,1119,False,169,733,302,118,11,51,99,1483,17,24,1524,12,12,100.0,Kast
2021-12-05 05:24:46.923710,7268,704,False,625,604,553,304,23,282,448,2839,21,15,2875,18,18,100.0,Boric
2021-12-05 05:24:46.923710,7268,705,False,360,322,359,148,12,125,218,1544,18,11,1573,10,10,100.0,Boric
2021-12-05 05:24:46.923710,7378,1049,False,318,1002,364,141,20,107,305,2257,22,22,2301,17,17,100.0,Kast
2021-12-05 05:24:46.923710,7378,1050,False,315,854,226,103,26,88,433,2045,18,14,2077,15,15,100.0,Kast
2021-12-05 05:24:46.923710,7378,1051,False,301,989,336,154,20,129,335,2264,30,18,2312,17,17,100.0,Kast
2021-12-05 05:24:46.923710,7078,273,False,822,942,437,518,42,347,670,3778,34,25,3837,21,21,100.0,Kast
2021-12-05 05:24:46.923710,7078,272,False,827,497,137,218,35,160,766,2640,19,8,2667,16,16,100.0,Boric
2021-12-05 05:24:46.923710,7078,274,False,908,1105,551,610,42,346,598,4160,44,8,4212,25,25,100.0,Kast
2021-12-05 05:24:46.923710,7078,275,False,1036,1119,568,533,43,345,835,4479,33,26,4538,25,25,100.0,Kast
2021-12-05 05:24:46.923710,7078,276,False,948,1101,653,512,46,379,593,4232,54,19,4305,25,25,100.0,Kast
2021-12-05 05:24:46.923710,7078,277,False,732,675,265,284,29,155,527,2667,33,10,2710,14,14,100.0,Boric
2021-12-05 05:24:46.923710,7078,278,False,1064,973,380,582,44,320,712,4075,39,11,4125,20,20,100.0,Boric
2021-12-05 05:24:46.923710,7078,279,False,787,574,186,302,44,168,581,2642,19,15,2676,16,16,100.0,Boric
2021-12-05 05:24:46.923710,7354,975,False,501,988,125,295,25,105,741,2780,18,4,2802,25,25,100.0,Kast
2021-12-05 05:24:46.923710,7354,976,False,234,829,176,313,14,78,247,1891,9,6,1906,12,12,100.0,Kast
2021-12-05 05:24:46.923710,7354,977,False,398,989,111,285,23,74,686,2566,11,3,2580,24,24,100.0,Kast
2021-12-05 05:24:46.923710,7354,978,False,392,939,162,316,25,88,404,2326,10,9,2345,21,21,100.0,Kast
2021-12-05 05:24:46.923710,7354,979,False,314,604,87,218,24,55,445,1747,7,5,1759,17,17,100.0,Kast
2021-12-05 05:24:46.923710,7354,998,False,368,666,103,233,20,72,443,1905,11,7,1923,17,17,100.0,Kast
2021-12-05 05:24:46.923710,7354,980,False,152,573,95,130,5,37,176,1168,6,4,1178,8,8,100.0,Kast
2021-12-05 05:24:46.923710,7354,981,False,130,505,137,124,7,48,120,1071,9,9,1089,8,8,100.0,Kast
2021-12-05 05:24:46.923710,7354,982,False,187,736,203,247,9,76,220,1678,15,5,1698,13,13,100.0,Kast
2021-12-05 05:24:46.923710,7354,983,False,169,669,185,253,48,74,148,1546,8,9,1563,12,12,100.0,Kast
2021-12-05 05:24:46.923710,7354,984,False,221,759,176,268,14,95,228,1761,16,5,1782,14,14,100.0,Kast
2021-12-05 05:24:46.923710,7354,985,False,162,534,101,166,14,67,163,1207,9,3,1219,10,10,100.0,Kast
2021-12-05 05:24:46.923710,7354,986,False,319,1292,304,450,21,154,414,2954,19,11,2984,20,20,100.0,Kast
2021-12-05 05:24:46.923710,7354,987,False,250,807,229,231,10,75,206,1808,15,21,1844,14,14,100.0,Kast
2021-12-05 05:24:46.923710,7354,999,False,170,605,147,200,7,73,166,1368,5,3,1376,10,10,100.0,Kast
2021-12-05 05:24:46.923710,7354,988,False,310,1119,238,297,16,124,396,2500,10,14,2524,18,18,100.0,Kast
2021-12-05 05:24:46.923710,7354,989,False,416,1047,214,395,12,122,363,2569,14,6,2589,15,15,100.0,Kast
2021-12-05 05:24:46.923710,7354,996,False,374,766,90,258,13,69,311,1881,11,8,1900,15,15,100.0,Kast
2021-12-05 05:24:46.923710,7354,990,False,321,1182,323,448,17,113,283,2687,21,16,2724,25,25,100.0,Kast
2021-12-05 05:24:46.923710,7354,991,False,636,2023,305,492,32,162,728,4378,21,9,4408,30,30,100.0,Kast
2021-12-05 05:24:46.923710,7354,992,False,488,1571,479,476,35,186,467,3702,41,32,3775,29,29,100.0,Kast
2021-12-05 05:24:46.923710,7354,993,False,521,1757,446,474,38,164,522,3922,28,22,3972,30,30,100.0,Kast
2021-12-05 05:24:46.923710,7354,994,False,273,825,259,267,15,103,246,1988,22,15,2025,19,19,100.0,Kast
2021-12-05 05:24:46.923710,7354,997,False,333,1080,246,287,15,114,373,2448,18,16,2482,18,18,100.0,Kast
2021-12-05 05:24:46.923710,7354,995,False,409,1441,279,488,19,169,389,3194,23,8,3225,24,24,100.0,Kast
2021-12-05 05:24:46.923710,7625,1068,False,320,488,280,157,28,242,616,2131,21,10,2162,17,17,100.0,Parisi
2021-12-05 05:24:46.923710,7625,1069,False,310,572,117,116,34,183,971,2303,11,5,2319,18,18,100.0,Parisi
2021-12-05 05:24:46.923710,7625,1070,False,424,447,133,96,36,154,821,2111,17,5,2133,16,16,100.0,Parisi
2021-12-05 05:24:46.923710,7429,2611,False,273,495,168,101,8,62,199,1306,11,6,1323,10,10,100.0,Kast
2021-12-05 05:24:46.923710,7429,2612,False,329,579,182,165,12,83,261,1611,8,4,1623,12,12,100.0,Kast
2021-12-05 05:24:46.923710,7429,2613,False,224,411,168,96,10,44,149,1102,9,14,1125,10,10,100.0,Kast
2021-12-05 05:24:46.923710,7429,2614,False,464,903,322,233,18,120,311,2371,26,20,2417,20,20,100.0,Kast
2021-12-05 05:24:46.923710,7405,1204,False,161,657,280,138,11,80,137,1464,12,11,1487,11,11,100.0,Kast
2021-12-05 05:24:46.923710,7607,2500,False,1120,1312,384,1031,56,196,159,4258,31,9,4298,19,19,100.0,Kast
2021-12-05 05:24:46.923710,7607,2502,False,772,1038,388,685,35,215,96,3229,10,10,3249,14,14,100.0,Kast
2021-12-05 05:24:46.923710,7607,2503,False,683,833,214,557,32,173,201,2693,10,4,2707,15,15,100.0,Kast
2021-12-05 05:24:46.923710,7607,2501,False,1431,1896,546,1559,60,222,184,5898,26,12,5936,24,24,100.0,Kast
2021-12-05 05:24:46.923710,7622,672,False,299,474,152,205,15,119,323,1587,11,8,1606,9,9,100.0,Kast
2021-12-05 05:24:46.923710,7720,170,False,57,86,118,38,1,28,121,449,13,7,469,5,5,100.0,Parisi
2021-12-05 05:24:46.923710,7661,522,False,126,198,59,82,7,43,44,559,5,0,564,3,3,100.0,Kast
2021-12-05 05:24:46.923710,7461,1355,False,208,926,285,210,12,73,220,1934,19,57,2010,15,15,100.0,Kast
2021-12-05 05:24:46.923710,7461,1357,False,249,806,162,140,5,52,262,1676,21,28,1725,12,12,100.0,Kast
2021-12-05 05:24:46.923710,7461,1356,False,281,1207,329,310,13,104,236,2480,25,36,2541,18,18,100.0,Kast
2021-12-05 05:24:46.923710,7723,829,False,169,341,165,142,13,111,208,1149,13,12,1174,9,9,100.0,Kast
2021-12-05 05:24:46.923710,7723,830,False,411,853,341,292,23,251,468,2639,54,38,2731,20,20,100.0,Kast
2021-12-05 05:24:46.923710,7608,2507,False,1107,429,165,333,67,193,169,2463,19,11,2493,12,12,100.0,Boric
2021-12-05 05:24:46.923710,7608,2504,False,1516,551,160,378,102,310,415,3432,23,5,3460,18,18,100.0,Boric
2021-12-05 05:24:46.923710,7608,2505,False,1628,553,201,431,104,275,343,3535,34,18,3587,18,18,100.0,Boric
2021-12-05 05:24:46.923710,7608,2509,False,1362,869,470,652,62,329,192,3936,23,10,3969,18,18,100.0,Boric
2021-12-05 05:24:46.923710,7608,2510,False,1309,811,431,611,60,340,191,3753,16,8,3777,18,18,100.0,Boric
2021-12-05 05:24:46.923710,7608,2511,False,1580,628,235,460,101,282,266,3552,27,9,3588,18,18,100.0,Boric
2021-12-05 05:24:46.923710,7608,2508,False,1532,814,322,499,70,331,250,3818,22,2,3842,17,17,100.0,Boric
2021-12-05 05:24:46.923710,7608,2506,False,1129,630,235,400,64,263,170,2891,24,8,2923,15,15,100.0,Boric
2021-12-05 05:24:46.923710,7608,2512,False,1318,922,476,441,70,302,198,3727,24,7,3758,18,18,100.0,Boric
2021-12-05 05:24:46.923710,7608,2513,False,1090,733,294,488,61,321,227,3214,12,4,3230,18,18,100.0,Boric
2021-12-05 05:24:46.923710,7608,2514,False,1090,753,228,413,39,313,315,3151,13,4,3168,18,18,100.0,Boric
2021-12-05 05:24:46.923710,7608,2515,False,1246,625,184,406,72,294,429,3256,22,3,3281,18,18,100.0,Boric
2021-12-05 05:24:46.923710,7394,1145,False,190,1072,258,171,14,79,157,1941,30,27,1998,14,14,100.0,Kast
2021-12-05 05:24:46.923710,7394,1144,False,196,809,204,139,14,51,120,1533,18,22,1573,12,12,100.0,Kast
2021-12-05 05:24:46.923710,7067,246,False,786,483,509,349,57,280,443,2907,32,14,2953,20,20,100.0,Boric
2021-12-05 05:24:46.923710,7067,245,False,803,463,343,222,71,221,572,2695,19,15,2729,20,20,100.0,Boric
2021-12-05 05:24:46.923710,7717,138,False,630,496,438,183,71,208,805,2831,10,5,2846,18,18,100.0,Parisi
2021-12-05 05:24:46.923710,7351,950,False,328,500,263,101,25,194,342,1753,21,8,1782,12,12,100.0,Kast
2021-12-05 05:24:46.923710,7351,952,False,468,741,330,171,21,214,610,2555,27,4,2586,15,15,100.0,Kast
2021-12-05 05:24:46.923710,7351,953,False,297,527,263,138,23,168,424,1840,30,6,1876,12,12,100.0,Kast
2021-12-05 05:24:46.923710,7351,954,False,244,492,254,122,11,163,208,1494,33,13,1540,12,12,100.0,Kast
2021-12-05 05:24:46.923710,7351,955,False,293,506,361,105,25,150,294,1734,30,17,1781,14,14,100.0,Kast
2021-12-05 05:24:46.923710,7351,956,False,483,637,180,96,25,133,602,2156,14,9,2179,16,16,100.0,Kast
2021-12-05 05:24:46.923710,7351,957,False,445,628,236,87,20,185,581,2182,27,10,2219,15,15,100.0,Kast
2021-12-05 05:24:46.923710,7351,951,False,480,639,353,130,34,168,487,2291,26,24,2341,15,15,100.0,Kast
2021-12-05 05:24:46.923710,7351,958,False,472,783,471,164,21,223,557,2691,54,30,2775,18,18,100.0,Kast
2021-12-05 05:24:46.923710,7351,959,False,383,751,363,176,27,240,481,2421,21,21,2463,18,18,100.0,Kast
2021-12-05 05:24:46.923710,7169,1927,False,1200,465,209,235,79,332,501,3021,20,9,3050,22,22,100.0,Boric
2021-12-05 05:24:46.923710,7169,1928,False,750,613,465,326,65,424,233,2876,26,15,2917,24,24,100.0,Boric
2021-12-05 05:24:46.923710,7169,1929,False,648,267,82,145,50,192,342,1726,4,4,1734,13,13,100.0,Boric
2021-12-05 05:24:46.923710,7169,1932,False,669,521,333,312,54,322,192,2403,32,9,2444,16,16,100.0,Boric
2021-12-05 05:24:46.923710,7169,1930,False,515,383,257,186,32,246,148,1767,22,11,1800,15,15,100.0,Boric
2021-12-05 05:24:46.923710,7169,1931,False,643,481,330,271,41,312,189,2267,14,8,2289,15,15,100.0,Boric
2021-12-05 05:24:46.923710,7169,1934,False,858,664,424,385,49,477,290,3147,25,19,3191,22,22,100.0,Boric
2021-12-05 05:24:46.923710,7169,1935,False,764,356,140,178,57,229,266,1990,5,3,1998,16,16,100.0,Boric
2021-12-05 05:24:46.923710,7169,1936,False,1010,706,413,312,71,453,368,3333,22,15,3370,22,22,100.0,Boric
2021-12-05 05:24:46.923710,7169,1937,False,957,628,473,319,61,453,274,3165,36,16,3217,22,22,100.0,Boric
2021-12-05 05:24:46.923710,7169,1938,False,716,469,328,219,47,287,188,2254,24,12,2290,15,15,100.0,Boric
2021-12-05 05:24:46.923710,7169,1939,False,1010,693,418,409,49,435,289,3303,30,6,3339,24,24,100.0,Boric
2021-12-05 05:24:46.923710,7169,1940,False,881,524,318,210,59,297,265,2554,12,8,2574,15,15,100.0,Boric
2021-12-05 05:24:46.923710,7169,1933,False,854,389,126,176,56,309,424,2334,10,4,2348,18,18,100.0,Boric
2021-12-05 05:24:46.923710,7169,1941,False,1255,759,498,374,81,544,381,3892,36,16,3944,23,23,100.0,Boric
2021-12-05 05:24:46.923710,7169,1942,False,816,527,299,269,34,389,226,2560,20,12,2592,19,19,100.0,Boric
2021-12-05 05:24:46.923710,7169,1943,False,751,558,359,291,40,411,324,2734,20,10,2764,19,19,100.0,Boric
2021-12-05 05:24:46.923710,7391,1138,False,211,471,181,72,19,70,79,1103,14,17,1134,10,10,100.0,Kast
2021-12-05 05:24:46.923710,7391,1139,False,191,445,130,40,14,50,95,965,12,19,996,9,9,100.0,Kast
2021-12-05 05:24:46.923710,7231,564,False,922,1091,402,650,22,377,463,3927,35,23,3985,24,24,100.0,Kast
2021-12-05 05:24:46.923710,7231,565,False,833,816,195,456,30,145,279,2754,8,8,2770,13,13,100.0,Boric
2021-12-05 05:24:46.923710,7231,566,False,670,805,213,508,20,251,434,2901,23,14,2938,14,14,100.0,Kast
2021-12-05 05:24:46.923710,7231,567,False,965,986,268,561,33,220,656,3689,31,7,3727,21,21,100.0,Kast
2021-12-05 05:24:46.923710,7231,568,False,949,1075,466,533,37,351,554,3965,41,28,4034,24,24,100.0,Kast
2021-12-05 05:24:46.923710,7231,569,False,534,593,148,365,20,118,207,1985,11,6,2002,10,10,100.0,Kast
2021-12-05 05:24:46.923710,7191,2147,False,664,526,315,368,24,214,124,2235,14,7,2256,16,16,100.0,Boric
2021-12-05 05:24:46.923710,7191,2152,False,1044,755,390,433,47,231,133,3033,14,10,3057,24,24,100.0,Boric
2021-12-05 05:24:46.923710,7191,2140,False,695,452,209,281,41,121,106,1905,11,5,1921,16,16,100.0,Boric
2021-12-05 05:24:46.923710,7191,2148,False,863,515,261,254,59,146,111,2209,13,9,2231,16,16,100.0,Boric
2021-12-05 05:24:46.923710,7191,2141,False,858,522,266,342,50,159,113,2310,22,4,2336,16,16,100.0,Boric
2021-12-05 05:24:46.923710,7191,2142,False,1193,752,474,564,62,292,182,3519,17,19,3555,24,24,100.0,Boric
2021-12-05 05:24:46.923710,7191,2143,False,724,682,343,444,26,217,101,2537,26,7,2570,20,20,100.0,Boric
2021-12-05 05:24:46.923710,7191,2144,False,747,474,278,381,23,186,83,2172,16,9,2197,15,15,100.0,Boric
2021-12-05 05:24:46.923710,7191,2149,False,874,455,293,377,34,170,89,2292,6,6,2304,15,15,100.0,Boric
2021-12-05 05:24:46.923710,7191,2137,False,551,470,241,326,22,159,91,1860,20,4,1884,17,17,100.0,Boric
2021-12-05 05:24:46.923710,7191,2138,False,704,541,279,376,37,208,136,2281,12,3,2296,17,17,100.0,Boric
2021-12-05 05:24:46.923710,7191,2139,False,719,538,226,389,34,204,193,2303,16,7,2326,16,16,100.0,Boric
2021-12-05 05:24:46.923710,7191,2145,False,641,423,212,300,28,187,58,1849,11,2,1862,15,15,100.0,Boric
2021-12-05 05:24:46.923710,7191,2150,False,655,430,226,349,32,170,86,1948,10,2,1960,15,15,100.0,Boric
2021-12-05 05:24:46.923710,7191,2146,False,941,541,296,458,56,242,188,2722,14,10,2746,18,18,100.0,Boric
2021-12-05 05:24:46.923710,7191,2151,False,758,567,294,436,43,207,118,2423,18,5,2446,18,18,100.0,Boric
2021-12-05 05:24:46.923710,7433,2619,False,231,688,218,121,14,88,342,1702,23,18,1743,12,12,100.0,Kast
2021-12-05 05:24:46.923710,7433,2620,False,248,604,205,162,15,99,305,1638,15,21,1674,12,12,100.0,Kast
2021-12-05 05:24:46.923710,7160,1851,False,794,585,390,367,41,266,145,2588,13,10,2611,15,15,100.0,Boric
2021-12-05 05:24:46.923710,7160,1882,False,760,574,359,361,46,297,150,2547,21,10,2578,15,15,100.0,Boric
2021-12-05 05:24:46.923710,7160,1852,False,1298,836,362,522,63,386,293,3760,16,5,3781,22,22,100.0,Boric
2021-12-05 05:24:46.923710,7160,1853,False,1301,425,146,299,84,290,402,2947,28,5,2980,18,18,100.0,Boric
2021-12-05 05:24:46.923710,7160,1854,False,1092,835,429,596,57,426,191,3626,28,9,3663,22,22,100.0,Boric
2021-12-05 05:24:46.923710,7160,1855,False,819,226,56,140,58,158,243,1700,12,5,1717,11,11,100.0,Boric
2021-12-05 05:24:46.923710,7160,1856,False,1591,467,166,333,118,278,399,3352,30,11,3393,22,22,100.0,Boric
2021-12-05 05:24:46.923710,7160,1857,False,1247,879,450,507,61,362,240,3746,14,9,3769,22,22,100.0,Boric
2021-12-05 05:24:46.923710,7160,1858,False,1157,295,107,207,83,216,235,2300,26,10,2336,13,13,100.0,Boric
2021-12-05 05:24:46.923710,7160,1859,False,872,696,437,399,38,276,158,2876,33,14,2923,21,21,100.0,Boric
2021-12-05 05:24:46.923710,7160,1860,False,640,485,254,332,39,248,114,2112,16,11,2139,15,15,100.0,Boric
2021-12-05 05:24:46.923710,7160,1883,False,714,527,238,319,32,257,161,2248,13,3,2264,15,15,100.0,Boric
2021-12-05 05:24:46.923710,7160,1861,False,1343,823,417,515,60,387,329,3874,23,181,4078,23,23,100.0,Boric
2021-12-05 05:24:46.923710,7160,1866,False,1508,881,377,432,100,337,282,3917,23,3,3943,22,22,100.0,Boric
2021-12-05 05:24:46.923710,7160,1862,False,1620,782,287,379,83,339,367,3857,24,3,3884,22,22,100.0,Boric
2021-12-05 05:24:46.923710,7160,1863,False,1092,541,268,381,49,290,180,2801,21,4,2826,15,15,100.0,Boric
2021-12-05 05:24:46.923710,7160,1884,False,1065,562,292,427,58,276,194,2874,19,2,2895,15,15,100.0,Boric
2021-12-05 05:24:46.923710,7160,1864,False,985,836,424,539,45,341,168,3338,23,8,3369,22,22,100.0,Boric
2021-12-05 05:24:46.923710,7160,1865,False,1321,853,398,514,61,410,304,3861,34,6,3901,22,22,100.0,Boric
2021-12-05 05:24:46.923710,7160,1867,False,835,297,93,187,45,167,226,1850,12,3,1865,12,12,100.0,Boric
2021-12-05 05:24:46.923710,7160,1868,False,1171,834,390,578,44,386,227,3630,29,7,3666,22,22,100.0,Boric
2021-12-05 05:24:46.923710,7160,1869,False,1146,824,375,581,67,343,211,3547,31,3,3581,22,22,100.0,Boric
2021-12-05 05:24:46.923710,7160,1870,False,1241,891,413,441,71,364,275,3696,29,6,3731,22,22,100.0,Boric
2021-12-05 05:24:46.923710,7160,1880,False,1354,892,396,424,70,394,283,3813,22,10,3845,22,22,100.0,Boric
2021-12-05 05:24:46.923710,7160,1871,False,1161,819,363,512,64,355,248,3522,27,7,3556,22,22,100.0,Boric
2021-12-05 05:24:46.923710,7160,1872,False,912,662,388,359,44,254,168,2787,20,7,2814,16,16,100.0,Boric
2021-12-05 05:24:46.923710,7160,1881,False,938,383,133,247,51,203,213,2168,17,4,2189,12,12,100.0,Boric
2021-12-05 05:24:46.923710,7160,1873,False,1122,774,367,407,53,340,203,3266,26,8,3300,20,20,100.0,Boric
2021-12-05 05:24:46.923710,7160,1874,False,1114,776,393,520,53,363,236,3455,17,6,3478,22,22,100.0,Boric
2021-12-05 05:24:46.923710,7160,1875,False,825,610,309,324,47,226,172,2513,23,5,2541,15,15,100.0,Boric
2021-12-05 05:24:46.923710,7160,1885,False,814,600,246,282,37,239,173,2391,7,4,2402,15,15,100.0,Boric
2021-12-05 05:24:46.923710,7160,1876,False,1224,820,392,526,75,393,297,3727,25,6,3758,22,22,100.0,Boric
2021-12-05 05:24:46.923710,7160,1877,False,1235,893,540,513,48,402,238,3869,28,11,3908,22,22,100.0,Boric
2021-12-05 05:24:46.923710,7160,1878,False,774,573,399,292,52,267,137,2494,23,9,2526,15,15,100.0,Boric
2021-12-05 05:24:46.923710,7160,1879,False,1547,539,172,313,82,268,312,3233,26,7,3266,20,20,100.0,Boric
2021-12-05 05:24:46.923710,7597,2486,False,1118,661,389,307,81,370,248,3174,13,12,3199,17,17,100.0,Boric
2021-12-05 05:24:46.923710,7597,2487,False,994,537,308,292,47,324,282,2784,20,3,2807,16,16,100.0,Boric
2021-12-05 05:24:46.923710,7597,2490,False,1330,470,185,265,103,400,594,3347,26,2,3375,21,21,100.0,Boric
2021-12-05 05:24:46.923710,7597,2485,False,1481,412,123,222,98,307,515,3158,14,4,3176,18,18,100.0,Boric
2021-12-05 05:24:46.923710,7597,2488,False,772,362,162,194,29,259,220,1998,13,0,2011,10,10,100.0,Boric
2021-12-05 05:24:46.923710,7597,2489,False,1089,330,164,212,91,282,327,2495,15,7,2517,15,15,100.0,Boric
2021-12-05 05:24:46.923710,7597,2491,False,1251,508,240,305,82,355,355,3096,21,4,3121,18,18,100.0,Boric
2021-12-05 05:24:46.923710,7597,2492,False,988,397,191,234,68,302,283,2463,11,7,2481,15,15,100.0,Boric
2021-12-05 05:24:46.923710,7597,2493,False,662,436,264,216,40,294,197,2109,25,7,2141,13,13,100.0,Boric
2021-12-05 05:24:46.923710,7597,2494,False,1035,640,429,432,62,537,287,3422,39,8,3469,19,19,100.0,Boric
2021-12-05 05:24:46.923710,7597,2495,False,1291,714,450,446,51,525,272,3749,26,8,3783,19,19,100.0,Boric
2021-12-05 05:24:46.923710,7597,2496,False,1097,567,312,396,60,462,281,3175,25,5,3205,19,19,100.0,Boric
2021-12-05 05:24:46.923710,7597,2497,False,876,565,215,301,44,372,328,2701,9,4,2714,20,20,100.0,Boric
2021-12-05 05:24:46.923710,7597,2498,False,941,508,185,286,64,332,467,2783,19,2,2804,20,20,100.0,Boric
2021-12-05 05:24:46.923710,7597,2499,False,1077,445,152,246,62,333,529,2844,14,1,2859,19,19,100.0,Boric
2021-12-05 05:24:46.923710,7671,1287,False,64,192,32,37,5,17,39,386,1,4,391,3,3,100.0,Kast
2021-12-05 05:24:46.923710,7560,2652,False,312,496,288,122,10,97,250,1575,17,25,1617,10,10,100.0,Kast
2021-12-05 05:24:46.923710,7235,585,False,381,609,234,282,11,137,230,1884,19,7,1910,15,15,100.0,Kast
2021-12-05 05:24:46.923710,7235,586,False,411,638,281,229,21,147,240,1967,31,9,2007,17,17,100.0,Kast
2021-12-05 05:24:46.923710,7015,34,False,20,19,43,7,3,4,48,144,1,1,146,1,1,100.0,Parisi
2021-12-05 05:24:46.923710,7440,2646,False,109,249,189,88,4,40,82,761,8,5,774,7,7,100.0,Kast
2021-12-05 05:24:46.923710,7565,1504,False,109,173,134,57,8,34,124,639,13,8,660,6,6,100.0,Kast
2021-12-05 05:24:46.923710,7260,654,False,391,409,306,291,20,89,138,1644,10,18,1672,12,12,100.0,Kast
2021-12-05 05:24:46.923710,7260,655,False,278,346,289,314,13,82,102,1424,5,3,1432,10,10,100.0,Kast
2021-12-05 05:24:46.923710,7017,59,False,255,196,137,62,33,107,916,1706,57,7,1770,21,21,100.0,Parisi
2021-12-05 05:24:46.923710,7220,2428,False,698,791,491,424,21,222,199,2846,17,18,2881,18,18,100.0,Kast
2021-12-05 05:24:46.923710,7220,2429,False,809,712,259,369,31,197,286,2663,13,14,2690,17,17,100.0,Boric
2021-12-05 05:24:46.923710,7427,2605,False,407,615,276,156,13,110,426,2003,14,9,2026,16,16,100.0,Kast
2021-12-05 05:24:46.923710,7427,2606,False,374,617,364,171,20,99,405,2050,18,23,2091,19,19,100.0,Kast
2021-12-05 05:24:46.923710,7427,2607,False,320,538,295,150,14,74,325,1716,13,13,1742,15,15,100.0,Kast
2021-12-05 05:24:46.923710,7282,749,False,677,1098,460,491,39,334,820,3919,39,25,3983,24,24,100.0,Kast
2021-12-05 05:24:46.923710,7282,750,False,587,919,471,365,15,276,598,3231,25,25,3281,20,20,100.0,Kast
2021-12-05 05:24:46.923710,7282,751,False,504,655,229,306,21,151,583,2449,16,8,2473,15,15,100.0,Kast
2021-12-05 05:24:46.923710,7460,1353,False,273,618,246,150,19,61,200,1567,14,12,1593,19,19,100.0,Kast
2021-12-05 05:24:46.923710,7460,1354,False,274,616,242,133,11,57,197,1530,12,22,1564,19,19,100.0,Kast
2021-12-05 05:24:46.923710,7470,1381,False,19,46,19,26,1,14,23,148,3,5,156,2,2,100.0,Kast
2021-12-05 05:24:46.923710,7613,1065,False,582,576,145,191,37,127,700,2358,12,4,2374,14,14,100.0,Parisi
2021-12-05 05:24:46.923710,7613,1066,False,480,583,311,168,23,172,453,2190,23,13,2226,14,14,100.0,Kast
2021-12-05 05:24:46.923710,7613,1067,False,568,870,338,283,36,281,539,2915,22,9,2946,19,19,100.0,Kast
2021-12-05 05:24:46.923710,7580,2653,False,145,186,78,52,7,24,84,576,8,4,588,4,4,100.0,Kast
2021-12-05 05:24:46.923710,7027,126,False,339,273,148,104,23,147,781,1815,13,7,1835,14,14,100.0,Parisi
2021-12-05 05:24:46.923710,7027,127,False,408,316,202,96,29,123,875,2049,17,8,2074,16,16,100.0,Parisi
2021-12-05 05:24:46.923710,7743,2673,False,64,148,61,42,4,20,75,414,8,12,434,3,3,100.0,Kast
2021-12-05 05:24:46.923710,7406,1205,False,215,475,143,87,12,40,157,1129,8,6,1143,11,11,100.0,Kast
2021-12-05 05:24:46.923710,7406,1206,False,147,469,185,112,14,55,90,1072,21,14,1107,12,12,100.0,Kast
2021-12-05 05:24:46.923710,7216,2411,False,686,493,149,194,50,117,230,1919,13,8,1940,12,12,100.0,Boric
2021-12-05 05:24:46.923710,7216,2412,False,736,763,289,426,33,154,222,2623,17,5,2645,14,14,100.0,Kast
2021-12-05 05:24:46.923710,7216,2409,False,695,936,458,400,43,221,257,3010,21,20,3051,22,22,100.0,Kast
2021-12-05 05:24:46.923710,7216,2410,False,869,1145,425,447,45,231,364,3526,20,18,3564,22,22,100.0,Kast
2021-12-05 05:24:46.923710,7216,2413,False,935,1010,240,358,49,200,498,3290,19,16,3325,24,24,100.0,Kast
2021-12-05 05:24:46.923710,7216,2414,False,1010,784,154,340,58,195,610,3151,14,7,3172,24,24,100.0,Boric
2021-12-05 05:24:46.923710,7216,2415,False,516,491,105,189,31,126,180,1638,13,5,1656,12,12,100.0,Boric
2021-12-05 05:24:46.923710,7216,2416,False,1113,800,182,367,79,187,510,3238,27,11,3276,24,24,100.0,Boric
2021-12-05 05:24:46.923710,7216,2417,False,592,902,393,480,33,196,202,2798,23,19,2840,21,21,100.0,Kast
2021-12-05 05:24:46.923710,7216,2418,False,616,844,409,457,23,220,218,2787,29,11,2827,21,21,100.0,Kast
2021-12-05 05:24:46.923710,7216,2419,False,666,900,390,501,29,224,225,2935,25,13,2973,21,21,100.0,Kast
2021-12-05 05:24:46.923710,7216,2420,False,753,1047,420,536,35,259,287,3337,31,9,3377,21,21,100.0,Kast
2021-12-05 05:24:46.923710,7216,2421,False,701,1016,613,391,40,240,236,3237,45,26,3308,24,24,100.0,Kast
2021-12-05 05:24:46.923710,7216,2422,False,731,1110,582,462,42,240,285,3452,38,22,3512,24,24,100.0,Kast
2021-12-05 05:24:46.923710,7658,821,False,50,211,89,47,6,28,63,494,3,8,505,4,4,100.0,Kast
2021-12-05 05:24:46.923710,7584,1420,False,40,25,33,17,4,11,35,165,7,15,187,2,2,100.0,Boric
2021-12-05 05:24:46.923710,7762,1474,False,18,34,18,16,0,11,11,108,1,1,110,2,2,100.0,Kast
2021-12-05 05:24:46.923710,7732,1094,False,77,206,88,36,9,34,104,554,7,15,576,4,4,100.0,Kast
2021-12-05 05:24:46.923710,7070,249,False,227,161,241,96,18,51,136,930,5,8,943,8,8,100.0,Provoste
2021-12-05 05:24:46.923710,7605,1273,False,108,228,128,56,10,58,212,800,8,12,820,5,5,100.0,Kast
2021-12-05 05:24:46.923710,7106,420,False,1205,994,498,448,75,389,457,4066,34,18,4118,26,26,100.0,Boric
2021-12-05 05:24:46.923710,7106,421,False,822,691,228,366,37,204,291,2639,18,5,2662,14,14,100.0,Boric
2021-12-05 05:24:46.923710,7106,422,False,1243,1094,446,546,87,452,590,4458,46,17,4521,30,30,100.0,Boric
2021-12-05 05:24:46.923710,7106,423,False,1424,1151,571,502,84,476,596,4804,43,23,4870,30,30,100.0,Boric
2021-12-05 05:24:46.923710,7106,424,False,1292,867,196,400,90,232,584,3661,34,9,3704,25,25,100.0,Boric
2021-12-05 05:24:46.923710,7106,425,False,697,660,226,346,46,265,310,2550,25,6,2581,15,15,100.0,Boric
2021-12-05 05:24:46.923710,7106,426,False,760,556,151,235,56,177,354,2289,12,4,2305,15,15,100.0,Boric
2021-12-05 05:24:46.923710,7106,427,False,981,853,372,434,63,380,489,3572,39,10,3621,23,23,100.0,Boric
2021-12-05 05:24:46.923710,7106,428,False,707,820,328,344,50,282,278,2809,23,9,2841,20,20,100.0,Kast
2021-12-05 05:24:46.923710,7106,429,False,480,441,149,202,27,174,213,1686,11,10,1707,11,11,100.0,Boric
2021-12-05 05:24:46.923710,7106,430,False,739,773,347,327,44,246,290,2766,18,12,2796,20,20,100.0,Kast
2021-12-05 05:24:46.923710,7106,431,False,604,559,183,217,41,176,283,2063,14,6,2083,12,12,100.0,Boric
2021-12-05 05:24:46.923710,7106,432,False,679,417,114,182,50,125,333,1900,9,7,1916,12,12,100.0,Boric
2021-12-05 05:24:46.923710,7106,433,False,1035,1002,273,330,69,206,433,3348,24,10,3382,18,18,100.0,Boric
2021-12-05 05:24:46.923710,7563,1412,False,220,199,452,98,20,56,112,1157,13,13,1183,9,9,100.0,Provoste
2021-12-05 05:24:46.923710,7267,700,False,907,1047,491,502,41,351,658,3997,32,19,4048,24,24,100.0,Kast
2021-12-05 05:24:46.923710,7267,703,False,442,535,442,246,24,172,253,2114,31,15,2160,14,14,100.0,Kast
2021-12-05 05:24:46.923710,7267,701,False,836,1131,608,454,40,291,515,3875,48,31,3954,23,23,100.0,Kast
2021-12-05 05:24:46.923710,7267,702,False,651,968,592,511,34,356,425,3537,39,21,3597,23,23,100.0,Kast
2021-12-05 05:24:46.923710,7739,1468,False,123,150,156,41,5,30,86,591,12,23,626,5,5,100.0,Provoste
2021-12-05 05:24:46.923710,7546,1062,False,348,1028,327,232,15,215,637,2802,28,33,2863,17,17,100.0,Kast
2021-12-05 05:24:46.923710,7058,228,False,268,256,246,102,27,105,285,1289,19,8,1316,15,15,100.0,Parisi
2021-12-05 05:24:46.923710,7058,227,False,285,261,263,93,33,117,323,1375,20,21,1416,15,15,100.0,Parisi
2021-12-05 05:24:46.923710,7058,226,False,244,191,145,59,32,78,391,1140,8,6,1154,16,16,100.0,Parisi
2021-12-05 05:24:46.923710,7692,1438,False,79,145,80,53,3,12,45,417,4,7,428,5,5,100.0,Kast
2021-12-05 05:24:46.923710,7229,559,False,1138,920,383,381,67,329,766,3984,42,17,4043,27,27,100.0,Boric
2021-12-05 05:24:46.923710,7229,560,False,952,817,419,414,36,337,546,3521,37,23,3581,23,23,100.0,Boric
2021-12-05 05:24:46.923710,7229,561,False,285,282,197,128,15,113,142,1162,17,8,1187,8,8,100.0,Boric
2021-12-05 05:24:46.923710,7365,1015,False,217,694,313,188,14,92,275,1793,23,27,1843,16,16,100.0,Kast
2021-12-05 05:24:46.923710,7365,1016,False,394,1024,324,161,34,116,610,2663,24,24,2711,21,21,100.0,Kast
2021-12-05 05:24:46.923710,7365,1018,False,363,1058,445,240,21,146,476,2749,23,13,2785,20,20,100.0,Kast
2021-12-05 05:24:46.923710,7365,1017,False,377,986,531,233,17,111,469,2724,34,53,2811,22,22,100.0,Kast
2021-12-05 05:24:46.923710,7367,1020,False,400,1110,420,264,30,142,791,3157,30,28,3215,20,20,100.0,Kast
2021-12-05 05:24:46.923710,7367,1021,False,313,704,127,109,20,76,708,2057,10,5,2072,14,14,100.0,Parisi
2021-12-05 05:24:46.923710,7367,1022,False,356,913,345,195,21,116,754,2700,27,28,2755,18,18,100.0,Kast
2021-12-05 05:24:46.923710,7367,1023,False,298,966,372,268,20,143,621,2688,17,11,2716,20,20,100.0,Kast
2021-12-05 05:24:46.923710,7249,627,False,640,845,636,598,32,204,460,3415,24,19,3458,22,22,100.0,Kast
2021-12-05 05:24:46.923710,7249,629,False,499,613,555,367,18,139,381,2572,18,21,2611,17,17,100.0,Kast
2021-12-05 05:24:46.923710,7249,628,False,193,203,85,99,10,52,165,807,2,3,812,6,6,100.0,Kast
2021-12-05 05:24:46.923710,7503,1512,False,523,365,201,99,15,109,189,1501,16,16,1533,12,12,100.0,Boric
2021-12-05 05:24:46.923710,7503,1513,False,316,283,200,99,12,118,103,1131,14,6,1151,11,11,100.0,Boric
2021-12-05 05:24:46.923710,7503,1514,False,510,407,138,95,30,96,251,1527,22,13,1562,12,12,100.0,Boric
2021-12-05 05:24:46.923710,7503,1515,False,363,316,264,107,8,167,155,1380,18,14,1412,11,11,100.0,Boric
2021-12-05 05:24:46.923710,7503,1516,False,372,317,252,86,12,132,175,1346,17,10,1373,11,11,100.0,Boric
2021-12-05 05:24:46.923710,7503,1517,False,346,330,196,87,14,91,123,1187,18,11,1216,11,11,100.0,Boric
2021-12-05 05:24:46.923710,7257,648,False,479,454,372,305,39,105,131,1885,12,14,1911,12,12,100.0,Boric
2021-12-05 05:24:46.923710,7257,649,False,328,307,250,222,14,112,73,1306,15,14,1335,9,9,100.0,Boric
2021-12-05 05:24:46.923710,7366,1019,False,288,1305,431,356,19,177,513,3089,42,39,3170,26,26,100.0,Kast
2021-12-05 05:24:46.923710,7540,1263,False,53,192,121,50,3,17,36,472,2,7,481,4,4,100.0,Kast
2021-12-05 05:24:46.923710,7633,2655,False,163,291,177,76,9,109,171,996,17,17,1030,7,7,100.0,Kast
2021-12-05 05:24:46.923710,7653,2657,False,702,515,208,123,63,107,198,1916,24,15,1955,11,11,100.0,Boric
2021-12-05 05:24:46.923710,7331,2795,False,253,824,695,325,15,105,191,2408,24,22,2454,21,21,100.0,Kast
2021-12-05 05:24:46.923710,7300,802,False,51,184,89,57,3,32,32,448,8,7,463,4,4,100.0,Kast
2021-12-05 05:24:46.923710,7093,333,False,719,546,318,368,41,305,728,3025,18,11,3054,22,22,100.0,Parisi
2021-12-05 05:24:46.923710,7093,334,False,772,521,363,277,47,255,728,2963,23,24,3010,23,23,100.0,Boric
2021-12-05 05:24:46.923710,7678,2661,False,69,311,119,58,6,22,85,670,15,5,690,4,4,100.0,Kast
2021-12-05 05:24:46.923710,7632,1429,False,206,346,183,99,9,46,168,1057,8,14,1079,6,6,100.0,Kast
2021-12-05 05:24:46.923710,7422,1253,False,329,837,412,206,29,179,221,2213,30,20,2263,18,18,100.0,Kast
2021-12-05 05:24:46.923710,7422,1254,False,412,882,477,242,28,220,283,2544,33,17,2594,17,17,100.0,Kast
2021-12-05 05:24:46.923710,7422,1255,False,391,595,206,136,32,136,316,1812,17,14,1843,12,12,100.0,Kast
2021-12-05 05:24:46.923710,7422,1256,False,337,692,291,135,22,126,232,1835,22,9,1866,12,12,100.0,Kast
2021-12-05 05:24:46.923710,7422,1257,False,430,970,571,254,42,197,331,2795,40,27,2862,19,19,100.0,Kast
2021-12-05 05:24:46.923710,7422,1258,False,297,721,344,218,25,153,264,2022,22,15,2059,13,13,100.0,Kast
2021-12-05 05:24:46.923710,7579,1270,False,268,842,289,310,16,100,186,2011,30,21,2062,15,15,100.0,Kast
2021-12-05 05:24:46.923710,7579,1271,False,175,605,190,197,14,64,122,1367,16,17,1400,10,10,100.0,Kast
2021-12-05 05:24:46.923710,7674,1290,False,196,353,102,126,9,54,124,964,5,4,973,6,6,100.0,Kast
2021-12-05 05:24:46.923710,7312,2761,False,531,2000,632,610,35,301,518,4627,46,58,4731,34,34,100.0,Kast
2021-12-05 05:24:46.923710,7588,1506,False,11,47,20,19,2,8,9,116,2,1,119,1,1,100.0,Kast
2021-12-05 05:24:46.923710,7765,2570,False,767,519,329,237,62,496,512,2922,21,7,2950,24,24,100.0,Boric
2021-12-05 05:24:46.923710,7765,2571,False,832,273,143,145,77,289,463,2222,19,7,2248,19,19,100.0,Boric
2021-12-05 05:24:46.923710,7765,2572,False,1178,362,306,225,84,451,558,3164,22,11,3197,23,23,100.0,Boric
2021-12-05 05:24:46.923710,7765,2573,False,816,577,697,390,57,624,259,3420,36,30,3486,24,24,100.0,Boric
2021-12-05 05:24:46.923710,7765,2574,False,593,440,408,229,45,484,284,2483,31,9,2523,18,18,100.0,Boric
2021-12-05 05:24:46.923710,7765,2575,False,879,414,232,215,67,441,634,2882,25,7,2914,24,24,100.0,Boric
2021-12-05 05:24:46.923710,7501,1500,False,75,142,47,26,3,5,16,314,5,6,325,3,3,100.0,Kast
2021-12-05 05:24:46.923710,7232,570,False,514,675,286,289,22,160,318,2264,20,14,2298,16,16,100.0,Kast
2021-12-05 05:24:46.923710,7232,571,False,433,582,214,320,9,187,342,2087,15,4,2106,15,15,100.0,Kast
2021-12-05 05:24:46.923710,7021,81,False,29,53,25,12,3,27,220,369,2,1,372,6,6,100.0,Parisi
2021-12-05 05:24:46.923710,7758,1470,False,51,202,126,42,3,16,22,462,2,3,467,4,4,100.0,Kast
2021-12-05 05:24:46.923710,7096,342,False,1002,1285,322,485,53,229,463,3839,34,22,3895,23,23,100.0,Kast
2021-12-05 05:24:46.923710,7096,343,False,537,767,265,293,30,169,266,2327,19,14,2360,14,14,100.0,Kast
2021-12-05 05:24:46.923710,7096,344,False,386,572,173,222,18,163,164,1698,16,8,1722,12,12,100.0,Kast
2021-12-05 05:24:46.923710,7648,820,False,118,387,154,101,10,56,136,962,10,19,991,6,6,100.0,Kast
2021-12-05 05:24:46.923710,7442,1306,False,649,1069,568,478,32,197,403,3396,24,15,3435,23,23,100.0,Kast
2021-12-05 05:24:46.923710,7442,1307,False,532,684,249,292,41,98,375,2271,7,5,2283,15,15,100.0,Kast
2021-12-05 05:24:46.923710,7442,1308,False,586,915,449,407,40,158,403,2958,22,8,2988,20,20,100.0,Kast
2021-12-05 05:24:46.923710,7442,1309,False,1052,1549,612,673,36,193,533,4648,27,10,4685,25,25,100.0,Kast
2021-12-05 05:24:46.923710,7442,1310,False,526,892,501,387,27,154,253,2740,32,12,2784,20,20,100.0,Kast
2021-12-05 05:24:46.923710,7442,1311,False,795,1157,701,403,50,176,430,3712,28,20,3760,25,25,100.0,Kast
2021-12-05 05:24:46.923710,7442,1312,False,578,818,186,218,31,90,515,2436,16,6,2458,16,16,100.0,Kast
2021-12-05 05:24:46.923710,7442,1313,False,825,1198,556,413,48,171,547,3758,25,17,3800,25,25,100.0,Kast
2021-12-05 05:24:46.923710,7442,1314,False,574,1044,468,377,41,142,404,3050,22,7,3079,19,19,100.0,Kast
2021-12-05 05:24:46.923710,7442,1315,False,375,689,359,286,26,114,187,2036,15,7,2058,15,15,100.0,Kast
2021-12-05 05:24:46.923710,7442,1316,False,557,992,533,324,27,135,287,2855,30,10,2895,25,25,100.0,Kast
2021-12-05 05:24:46.923710,7442,1317,False,334,723,281,257,16,87,161,1859,11,9,1879,16,16,100.0,Kast
2021-12-05 05:24:46.923710,7442,1323,False,537,512,123,160,35,89,498,1954,10,8,1972,15,15,100.0,Boric
2021-12-05 05:24:46.923710,7442,1318,False,724,1140,439,349,35,161,573,3421,27,9,3457,22,22,100.0,Kast
2021-12-05 05:24:46.923710,7442,1319,False,435,740,475,267,23,114,233,2287,24,7,2318,16,16,100.0,Kast
2021-12-05 05:24:46.923710,7442,1320,False,670,1224,583,520,31,199,444,3671,30,11,3712,25,25,100.0,Kast
2021-12-05 05:24:46.923710,7442,1321,False,802,1183,633,433,50,152,493,3746,22,15,3783,25,25,100.0,Kast
2021-12-05 05:24:46.923710,7442,1322,False,984,1499,447,419,47,132,595,4123,17,12,4152,25,25,100.0,Kast
2021-12-05 05:24:46.923710,7053,221,False,770,618,329,202,48,161,644,2772,13,10,2795,20,20,100.0,Boric
2021-12-05 05:24:46.923710,7053,220,False,533,638,495,372,24,207,416,2685,27,17,2729,22,22,100.0,Kast
2021-12-05 05:24:46.923710,7053,219,False,544,447,199,195,30,152,653,2220,12,6,2238,20,20,100.0,Parisi
2021-12-05 05:24:46.923710,7053,218,False,397,333,101,157,16,134,535,1673,5,3,1681,14,14,100.0,Parisi
2021-12-05 05:24:46.923710,7053,217,False,760,597,507,270,36,248,677,3095,22,10,3127,21,21,100.0,Boric
2021-12-05 05:24:46.923710,7053,216,False,505,447,355,180,12,132,372,2003,9,16,2028,15,15,100.0,Boric
2021-12-05 05:24:46.923710,7053,215,False,1178,1013,760,532,46,389,884,4802,39,15,4856,30,30,100.0,Boric
2021-12-05 05:24:46.923710,7053,214,False,518,336,131,144,21,109,447,1706,12,3,1721,15,15,100.0,Boric
2021-12-05 05:24:46.923710,7053,213,False,631,438,174,204,34,120,548,2149,18,4,2171,16,16,100.0,Boric
2021-12-05 05:24:46.923710,7053,212,False,902,789,599,439,45,343,747,3864,38,15,3917,27,27,100.0,Boric
2021-12-05 05:24:46.923710,7053,211,False,595,681,493,352,32,253,482,2888,32,8,2928,21,21,100.0,Kast
2021-12-05 05:24:46.923710,7053,210,False,1046,1002,892,451,53,358,729,4531,52,37,4620,33,33,100.0,Boric
2021-12-05 05:24:46.923710,7180,2025,False,887,447,231,194,70,243,136,2208,22,8,2238,17,17,100.0,Boric
2021-12-05 05:24:46.923710,7180,2026,False,1043,446,264,229,109,233,177,2501,10,4,2515,17,17,100.0,Boric
2021-12-05 05:24:46.923710,7180,2024,False,868,378,283,231,63,298,179,2300,17,8,2325,15,15,100.0,Boric
2021-12-05 05:24:46.923710,7180,2020,False,763,432,289,247,54,323,143,2251,16,8,2275,17,17,100.0,Boric
2021-12-05 05:24:46.923710,7180,2021,False,1137,447,258,309,73,242,139,2605,16,3,2624,17,17,100.0,Boric
2021-12-05 05:24:46.923710,7180,2022,False,956,580,323,343,87,338,172,2799,24,151,2974,21,21,100.0,Boric
2021-12-05 05:24:46.923710,7180,2019,False,535,232,161,164,41,163,71,1367,13,4,1384,10,10,100.0,Boric
2021-12-05 05:24:46.923710,7180,2023,False,1387,579,337,417,118,418,278,3534,38,14,3586,24,24,100.0,Boric
2021-12-05 05:24:46.923710,7181,2027,False,537,240,202,193,41,239,113,1565,15,3,1583,12,12,100.0,Boric
2021-12-05 05:24:46.923710,7181,2028,False,740,472,328,289,62,393,196,2480,37,9,2526,20,20,100.0,Boric
2021-12-05 05:24:46.923710,7181,2038,False,1008,461,298,258,75,457,262,2819,15,6,2840,20,20,100.0,Boric
2021-12-05 05:24:46.923710,7181,2033,False,572,221,129,115,37,181,115,1370,6,1,1377,12,12,100.0,Boric
2021-12-05 05:24:46.923710,7181,2037,False,1107,364,299,298,84,345,166,2663,17,6,2686,18,18,100.0,Boric
2021-12-05 05:24:46.923710,7181,2031,False,958,298,268,162,93,276,197,2252,12,10,2274,18,18,100.0,Boric
2021-12-05 05:24:46.923710,7181,2029,False,850,467,315,275,72,354,254,2587,26,8,2621,24,24,100.0,Boric
2021-12-05 05:24:46.923710,7181,2030,False,611,217,139,131,51,183,216,1548,14,2,1564,12,12,100.0,Boric
2021-12-05 05:24:46.923710,7181,2032,False,517,198,151,145,44,183,92,1330,23,7,1360,12,12,100.0,Boric
2021-12-05 05:24:46.923710,7181,2034,False,652,327,161,181,62,235,277,1895,32,11,1938,15,15,100.0,Boric
2021-12-05 05:24:46.923710,7181,2035,False,909,372,332,173,61,286,170,2303,20,16,2339,20,20,100.0,Boric
2021-12-05 05:24:46.923710,7181,2036,False,965,388,279,178,103,271,188,2372,23,9,2404,16,16,100.0,Boric
2021-12-05 05:24:46.923710,7574,2470,False,823,566,226,293,35,312,413,2668,8,4,2680,12,12,100.0,Boric
2021-12-05 05:24:46.923710,7574,2465,False,824,730,374,462,50,412,335,3187,27,11,3225,16,16,100.0,Boric
2021-12-05 05:24:46.923710,7574,2469,False,529,338,113,180,37,208,258,1663,11,9,1683,10,10,100.0,Boric
2021-12-05 05:24:46.923710,7574,2472,False,452,349,288,237,21,272,165,1784,28,4,1816,10,10,100.0,Boric
2021-12-05 05:24:46.923710,7574,2466,False,797,467,184,247,49,260,328,2332,14,5,2351,12,12,100.0,Boric
2021-12-05 05:24:46.923710,7574,2471,False,351,336,191,192,21,227,130,1448,6,4,1458,8,8,100.0,Boric
2021-12-05 05:24:46.923710,7574,2468,False,544,451,144,211,41,272,469,2132,10,2,2144,14,14,100.0,Boric
2021-12-05 05:24:46.923710,7574,2467,False,1329,736,250,384,89,475,826,4089,25,11,4125,24,24,100.0,Boric
2021-12-05 05:24:46.923710,7574,2473,False,697,528,475,260,35,358,260,2613,40,20,2673,15,15,100.0,Boric
2021-12-05 05:24:46.923710,7574,2474,False,774,677,381,309,40,327,343,2851,26,17,2894,15,15,100.0,Boric
2021-12-05 05:24:46.923710,7399,1175,False,419,604,138,176,26,116,321,1800,12,4,1816,11,11,100.0,Kast
2021-12-05 05:24:46.923710,7399,1176,False,210,436,76,100,13,79,352,1266,6,0,1272,10,10,100.0,Kast
2021-12-05 05:24:46.923710,7399,1177,False,334,868,330,227,25,210,273,2267,28,23,2318,16,16,100.0,Kast
2021-12-05 05:24:46.923710,7399,1178,False,468,1078,324,261,24,155,468,2778,20,19,2817,16,16,100.0,Kast
2021-12-05 05:24:46.923710,7399,1179,False,302,510,100,126,14,97,427,1576,8,4,1588,12,12,100.0,Kast
2021-12-05 05:24:46.923710,7399,1180,False,342,925,312,273,30,178,271,2331,20,30,2381,18,18,100.0,Kast
2021-12-05 05:24:46.923710,7399,1181,False,270,538,212,123,14,108,221,1486,17,10,1513,10,10,100.0,Kast
2021-12-05 05:24:46.923710,7399,1182,False,328,483,89,138,23,111,430,1602,13,5,1620,12,12,100.0,Kast
2021-12-05 05:24:46.923710,7399,1183,False,265,626,201,174,10,118,238,1632,10,6,1648,10,10,100.0,Kast
2021-12-05 05:24:46.923710,7399,1184,False,421,905,360,290,23,215,355,2569,25,16,2610,15,15,100.0,Kast
2021-12-05 05:24:46.923710,7399,1185,False,311,661,299,195,22,132,225,1845,41,27,1913,13,13,100.0,Kast
2021-12-05 05:24:46.923710,7399,1186,False,282,688,312,204,18,164,284,1952,42,27,2021,15,15,100.0,Kast
2021-12-05 05:24:46.923710,7399,1187,False,312,545,125,141,14,82,303,1522,12,7,1541,10,10,100.0,Kast
2021-12-05 05:24:46.923710,7052,209,False,576,488,289,274,37,146,277,2087,17,14,2118,16,16,100.0,Boric
2021-12-05 05:24:46.923710,7643,1283,False,61,269,44,30,3,21,25,453,1,4,458,3,3,100.0,Kast
2021-12-05 05:24:46.923710,7438,2637,False,198,395,136,129,8,39,178,1083,14,12,1109,7,7,100.0,Kast
2021-12-05 05:24:46.923710,7438,2638,False,232,550,219,155,22,42,178,1398,10,13,1421,12,12,100.0,Kast
2021-12-05 05:24:46.923710,7438,2639,False,460,913,311,190,29,92,388,2383,27,21,2431,19,19,100.0,Kast
2021-12-05 05:24:46.923710,7438,2640,False,353,964,369,242,18,112,350,2408,27,19,2454,20,20,100.0,Kast
2021-12-05 05:24:46.923710,7750,1096,False,270,743,101,168,21,120,631,2054,9,6,2069,19,19,100.0,Kast
2021-12-05 05:24:46.923710,7750,1097,False,328,868,127,226,34,124,823,2530,9,5,2544,22,22,100.0,Kast
2021-12-05 05:24:46.923710,7750,1098,False,211,983,267,249,18,166,465,2359,17,22,2398,18,18,100.0,Kast
2021-12-05 05:24:46.923710,7215,2403,False,720,1134,334,368,30,281,339,3206,30,17,3253,22,22,100.0,Kast
2021-12-05 05:24:46.923710,7215,2404,False,906,1235,407,372,32,359,435,3746,32,15,3793,22,22,100.0,Kast
2021-12-05 05:24:46.923710,7215,2406,False,1271,867,231,320,47,262,690,3688,31,8,3727,24,24,100.0,Boric
2021-12-05 05:24:46.923710,7215,2405,False,926,729,189,253,34,191,291,2613,18,9,2640,16,16,100.0,Boric
2021-12-05 05:24:46.923710,7215,2407,False,678,1063,401,289,25,254,334,3044,19,24,3087,21,21,100.0,Kast
2021-12-05 05:24:46.923710,7215,2408,False,930,1006,308,300,37,270,541,3392,26,10,3428,21,21,100.0,Kast
2021-12-05 05:24:46.923710,7719,169,False,475,550,671,200,48,217,1134,3295,22,16,3333,23,23,100.0,Parisi
2021-12-05 05:24:46.923710,7486,1402,False,160,307,157,81,7,20,57,789,8,14,811,7,7,100.0,Kast
2021-12-05 05:24:46.923710,7254,641,False,425,577,586,348,12,149,248,2345,13,18,2376,16,16,100.0,Provoste
2021-12-05 05:24:46.923710,7254,642,False,394,550,645,323,27,126,221,2286,19,22,2327,15,15,100.0,Provoste
2021-12-05 05:24:46.923710,7718,168,False,980,790,591,301,62,249,1158,4131,25,16,4172,25,25,100.0,Parisi
2021-12-05 05:24:46.923710,7434,2621,False,340,707,253,159,15,120,285,1879,24,11,1914,15,15,100.0,Kast
2021-12-05 05:24:46.923710,7434,2622,False,272,652,316,199,19,104,174,1736,25,10,1771,15,15,100.0,Kast
2021-12-05 05:24:46.923710,7434,2623,False,335,534,120,133,15,78,366,1581,16,8,1605,15,15,100.0,Kast
2021-12-05 05:24:46.923710,7434,2624,False,288,603,305,158,16,87,171,1628,24,25,1677,15,15,100.0,Kast
2021-12-05 05:24:46.923710,7434,2625,False,392,824,327,242,33,164,264,2246,24,10,2280,15,15,100.0,Kast
2021-12-05 05:24:46.923710,7086,303,False,714,870,389,331,28,229,711,3272,33,25,3330,20,20,100.0,Kast
2021-12-05 05:24:46.923710,7077,271,False,667,736,279,539,28,138,332,2719,9,7,2735,17,17,100.0,Kast
2021-12-05 05:24:46.923710,7261,656,False,238,280,270,219,11,53,75,1146,12,22,1180,10,10,100.0,Kast
2021-12-05 05:24:46.923710,7261,657,False,177,240,230,183,5,52,74,961,9,18,988,8,8,100.0,Kast
2021-12-05 05:24:46.923710,7570,1415,False,104,218,104,83,5,49,157,720,11,14,745,6,6,100.0,Kast
2021-12-05 05:24:46.923710,7130,1629,False,1519,508,191,393,52,100,130,2893,8,8,2909,16,16,100.0,Boric
2021-12-05 05:24:46.923710,7130,1630,False,1715,731,173,422,67,90,120,3318,11,3,3332,16,16,100.0,Boric
2021-12-05 05:24:46.923710,7130,1616,False,790,404,146,267,39,79,79,1804,25,6,1835,13,13,100.0,Boric
2021-12-05 05:24:46.923710,7130,1619,False,1072,631,256,322,56,77,89,2503,11,3,2517,15,15,100.0,Boric
2021-12-05 05:24:46.923710,7130,1622,False,1493,869,338,445,67,133,138,3483,23,6,3512,20,20,100.0,Boric
2021-12-05 05:24:46.923710,7130,1631,False,971,536,260,367,37,104,62,2337,8,9,2354,12,12,100.0,Boric
2021-12-05 05:24:46.923710,7130,1618,False,1929,426,169,417,62,95,144,3242,14,5,3261,15,15,100.0,Boric
2021-12-05 05:24:46.923710,7130,1623,False,1225,683,269,361,48,127,91,2804,14,16,2834,17,17,100.0,Boric
2021-12-05 05:24:46.923710,7130,1620,False,663,618,186,353,32,122,101,2075,12,11,2098,18,18,100.0,Boric
2021-12-05 05:24:46.923710,7130,1617,False,1194,911,347,477,41,155,103,3228,15,10,3253,22,22,100.0,Boric
2021-12-05 05:24:46.923710,7130,1621,False,1235,872,335,463,57,165,135,3262,22,7,3291,20,20,100.0,Boric
2021-12-05 05:24:46.923710,7130,1624,False,883,779,264,434,40,154,97,2651,15,7,2673,18,18,100.0,Boric
2021-12-05 05:24:46.923710,7130,1625,False,1038,608,220,370,50,134,136,2556,19,8,2583,16,16,100.0,Boric
2021-12-05 05:24:46.923710,7130,1626,False,1016,722,232,418,67,129,130,2714,22,6,2742,18,18,100.0,Boric
2021-12-05 05:24:46.923710,7130,1615,False,1391,859,329,392,74,107,73,3225,18,7,3250,18,18,100.0,Boric
2021-12-05 05:24:46.923710,7130,1627,False,983,865,275,463,61,146,124,2917,20,9,2946,20,20,100.0,Boric
2021-12-05 05:24:46.923710,7130,1628,False,1032,595,172,363,54,92,112,2420,3,5,2428,14,14,100.0,Boric
2021-12-05 05:24:46.923710,7130,1632,False,1212,558,173,355,57,77,115,2547,17,8,2572,14,14,100.0,Boric
2021-12-05 05:24:46.923710,7132,1633,False,1232,812,353,422,90,223,144,3276,50,9,3335,24,24,100.0,Boric
2021-12-05 05:24:46.923710,7132,1636,False,932,582,233,267,61,160,123,2358,5,7,2370,19,19,100.0,Boric
2021-12-05 05:24:46.923710,7132,1643,False,711,545,196,345,42,153,90,2082,14,8,2104,15,15,100.0,Boric
2021-12-05 05:24:46.923710,7132,1635,False,571,456,143,201,50,99,91,1611,9,3,1623,14,14,100.0,Boric
2021-12-05 05:24:46.923710,7132,1634,False,643,438,158,183,46,93,97,1658,15,7,1680,13,13,100.0,Boric
2021-12-05 05:24:46.923710,7132,1644,False,826,525,194,245,68,133,101,2092,8,18,2118,14,14,100.0,Boric
2021-12-05 05:24:46.923710,7132,1641,False,434,458,154,216,36,109,56,1463,13,7,1483,13,13,100.0,Kast
2021-12-05 05:24:46.923710,7132,1646,False,584,507,156,274,32,124,86,1763,10,7,1780,13,13,100.0,Boric
2021-12-05 05:24:46.923710,7132,1637,False,548,542,170,312,48,153,78,1851,8,4,1863,15,15,100.0,Boric
2021-12-05 05:24:46.923710,7132,1642,False,674,548,203,300,47,167,112,2051,14,4,2069,15,15,100.0,Boric
2021-12-05 05:24:46.923710,7132,1638,False,681,441,122,252,50,135,113,1794,5,5,1804,13,13,100.0,Boric
2021-12-05 05:24:46.923710,7132,1645,False,392,404,146,203,27,124,68,1364,14,6,1384,13,13,100.0,Kast
2021-12-05 05:24:46.923710,7132,1639,False,1057,619,259,394,54,158,89,2630,10,10,2650,17,17,100.0,Boric
2021-12-05 05:24:46.923710,7132,1640,False,970,683,245,320,81,188,182,2669,17,4,2690,20,20,100.0,Boric
2021-12-05 05:24:46.923710,7295,785,False,370,901,287,285,14,85,214,2156,16,16,2188,15,15,100.0,Kast
2021-12-05 05:24:46.923710,7295,786,False,408,922,445,369,18,112,167,2441,23,16,2480,20,20,100.0,Kast
2021-12-05 05:24:46.923710,7295,787,False,478,904,278,368,13,131,255,2427,16,9,2452,17,17,100.0,Kast
2021-12-05 05:24:46.923710,7295,788,False,437,1079,394,480,12,147,243,2792,17,18,2827,20,20,100.0,Kast
2021-12-05 05:24:46.923710,7295,789,False,196,513,200,174,8,62,117,1270,21,4,1295,10,10,100.0,Kast
2021-12-05 05:24:46.923710,7295,790,False,367,968,359,412,13,109,180,2408,31,9,2448,20,20,100.0,Kast
2021-12-05 05:24:46.923710,7018,60,False,5,7,3,2,1,1,9,28,0,1,29,1,1,100.0,Parisi
2021-12-05 05:24:46.923710,7629,1279,False,721,909,221,314,55,185,569,2974,10,12,2996,18,18,100.0,Kast
2021-12-05 05:24:46.923710,7629,1276,False,180,470,91,106,9,103,350,1309,8,1,1318,10,10,100.0,Kast
2021-12-05 05:24:46.923710,7629,1277,False,391,643,132,188,29,163,587,2133,16,7,2156,15,15,100.0,Kast
2021-12-05 05:24:46.923710,7629,1278,False,326,769,263,224,9,188,316,2095,24,9,2128,15,15,100.0,Kast
2021-12-05 05:24:46.923710,7705,1088,False,29,72,40,11,2,23,51,228,5,12,245,2,2,100.0,Kast
2021-12-05 05:24:46.923710,7278,738,False,182,387,231,168,16,82,223,1289,12,7,1308,10,10,100.0,Kast
2021-12-05 05:24:46.923710,7278,739,False,367,740,364,360,13,166,338,2348,29,8,2385,16,16,100.0,Kast
2021-12-05 05:24:46.923710,7682,2665,False,182,210,136,94,12,64,140,838,10,7,855,6,6,100.0,Kast
2021-12-05 05:24:46.923710,7577,670,False,272,444,279,171,11,130,216,1523,13,9,1545,11,11,100.0,Kast
2021-12-05 05:24:46.923710,7305,812,False,692,1813,531,499,34,179,274,4022,66,36,4124,26,26,100.0,Kast
2021-12-05 05:24:46.923710,7321,2776,False,195,642,254,221,8,82,156,1558,12,6,1576,13,13,100.0,Kast
2021-12-05 05:24:46.923710,7321,2777,False,184,645,262,167,11,65,157,1491,15,6,1512,14,14,100.0,Kast
2021-12-05 05:24:46.923710,7284,753,False,519,1404,726,511,18,216,490,3884,155,33,4072,30,30,100.0,Kast
2021-12-05 05:24:46.923710,7701,827,False,36,130,90,50,1,40,46,393,9,5,407,3,3,100.0,Kast
2021-12-05 05:24:46.923710,7343,923,False,609,591,354,191,42,185,627,2599,27,11,2637,15,15,100.0,Parisi
2021-12-05 05:24:46.923710,7343,924,False,663,631,268,177,43,155,655,2592,13,8,2613,15,15,100.0,Boric
2021-12-05 05:24:46.923710,7343,925,False,574,574,475,189,35,203,534,2584,16,14,2614,15,15,100.0,Boric
2021-12-05 05:24:46.923710,7343,926,False,497,623,579,269,23,240,442,2673,27,17,2717,18,18,100.0,Kast
2021-12-05 05:24:46.923710,7343,927,False,458,582,430,236,28,213,414,2361,15,13,2389,15,15,100.0,Kast
2021-12-05 05:24:46.923710,7343,928,False,434,540,486,200,31,186,423,2300,28,21,2349,15,15,100.0,Kast
2021-12-05 05:24:46.923710,7343,929,False,852,904,609,422,65,333,899,4084,32,20,4136,22,22,100.0,Kast
2021-12-05 05:24:46.923710,7223,2443,False,1001,641,409,421,49,386,437,3344,36,8,3388,18,18,100.0,Boric
2021-12-05 05:24:46.923710,7223,2444,False,1053,615,275,371,58,315,394,3081,18,3,3102,16,16,100.0,Boric
2021-12-05 05:24:46.923710,7223,2442,False,1030,751,365,438,50,444,638,3716,41,14,3771,22,22,100.0,Boric
2021-12-05 05:24:46.923710,7223,2447,False,1298,794,464,431,82,485,609,4163,26,11,4200,24,24,100.0,Boric
2021-12-05 05:24:46.923710,7223,2445,False,824,392,149,201,48,207,359,2180,16,8,2204,13,13,100.0,Boric
2021-12-05 05:24:46.923710,7223,2446,False,1073,892,509,451,44,542,582,4093,32,21,4146,24,24,100.0,Boric
2021-12-05 05:24:46.923710,7223,2441,False,818,772,463,467,45,458,385,3408,31,15,3454,22,22,100.0,Boric
2021-12-05 05:24:46.923710,7223,2448,False,540,277,113,143,36,128,200,1437,15,5,1457,8,8,100.0,Boric
2021-12-05 05:24:46.923710,7223,2449,False,920,861,605,475,58,504,408,3831,29,20,3880,23,23,100.0,Boric
2021-12-05 05:24:46.923710,7223,2450,False,866,675,443,392,43,424,551,3394,19,16,3429,22,22,100.0,Boric
2021-12-05 05:24:46.923710,7223,2451,False,1463,1024,443,439,86,371,540,4366,27,11,4404,23,23,100.0,Boric
2021-12-05 05:24:46.923710,7193,2153,False,1359,514,284,464,87,338,436,3482,18,6,3506,24,24,100.0,Boric
2021-12-05 05:24:46.923710,7193,2165,False,467,391,206,245,23,209,91,1632,12,4,1648,14,14,100.0,Boric
2021-12-05 05:24:46.923710,7193,2155,False,1011,687,481,507,52,518,309,3565,20,9,3594,24,24,100.0,Boric
2021-12-05 05:24:46.923710,7193,2156,False,1158,718,481,542,64,494,364,3821,29,7,3857,24,24,100.0,Boric
2021-12-05 05:24:46.923710,7193,2157,False,1340,768,413,473,75,369,422,3860,26,13,3899,24,24,100.0,Boric
2021-12-05 05:24:46.923710,7193,2167,False,508,369,265,260,37,220,143,1802,11,11,1824,14,14,100.0,Boric
2021-12-05 05:24:46.923710,7193,2158,False,995,694,588,467,62,455,260,3521,24,15,3560,24,24,100.0,Boric
2021-12-05 05:24:46.923710,7193,2159,False,894,635,478,444,50,415,199,3115,30,32,3177,24,24,100.0,Boric
2021-12-05 05:24:46.923710,7193,2160,False,1456,867,546,635,83,389,264,4240,18,10,4268,24,24,100.0,Boric
2021-12-05 05:24:46.923710,7193,2161,False,1177,791,459,452,76,426,331,3712,49,13,3774,24,24,100.0,Boric
2021-12-05 05:24:46.923710,7193,2162,False,944,718,481,557,71,465,258,3494,25,15,3534,24,24,100.0,Boric
2021-12-05 05:24:46.923710,7193,2163,False,813,532,436,320,60,325,191,2677,28,13,2718,17,17,100.0,Boric
2021-12-05 05:24:46.923710,7193,2164,False,828,479,410,299,53,306,192,2567,16,16,2599,17,17,100.0,Boric
2021-12-05 05:24:46.923710,7193,2166,False,866,522,358,294,47,320,273,2680,29,14,2723,17,17,100.0,Boric
2021-12-05 05:24:46.923710,7193,2154,False,1020,658,469,520,55,443,261,3426,22,13,3461,24,24,100.0,Boric
2021-12-05 05:24:46.923710,7255,643,False,386,534,422,413,27,126,181,2089,7,5,2101,14,14,100.0,Kast
2021-12-05 05:24:46.923710,7255,644,False,529,558,499,359,13,147,211,2316,14,12,2342,16,16,100.0,Kast
2021-12-05 05:24:46.923710,7401,1195,False,194,667,224,99,19,109,262,1574,16,6,1596,11,11,100.0,Kast
2021-12-05 05:24:46.923710,7401,1196,False,189,585,234,75,17,77,194,1371,23,16,1410,10,10,100.0,Kast
2021-12-05 05:24:46.923710,7073,265,False,867,459,520,240,42,265,592,2985,30,20,3035,22,22,100.0,Boric
2021-12-05 05:24:46.923710,7454,1344,False,1,24,5,7,0,3,3,43,0,1,44,1,1,100.0,Kast
2021-12-05 05:24:46.923710,7240,598,False,854,696,556,399,53,257,451,3266,32,35,3333,22,22,100.0,Boric
2021-12-05 05:24:46.923710,7240,599,False,646,564,429,371,31,248,340,2629,35,33,2697,17,17,100.0,Boric
2021-12-05 05:24:46.923710,7013,29,False,190,360,157,100,14,48,356,1225,7,9,1241,10,10,100.0,Kast
2021-12-05 05:24:46.923710,7013,30,False,213,398,148,103,13,52,387,1314,9,1,1324,11,12,91.67,Kast
2021-12-05 05:24:46.923710,7744,523,False,99,95,40,42,3,28,56,363,3,1,367,3,3,100.0,Boric
2021-12-05 05:24:46.923710,7239,595,False,285,228,88,134,18,54,177,984,2,5,991,8,8,100.0,Boric
2021-12-05 05:24:46.923710,7239,596,False,692,712,588,468,32,198,310,3000,26,52,3078,22,22,100.0,Kast
2021-12-05 05:24:46.923710,7239,597,False,564,674,556,536,33,212,258,2833,20,33,2886,20,20,100.0,Kast
2021-12-05 05:24:46.923710,7256,645,False,638,612,450,453,43,160,182,2538,38,29,2605,16,16,100.0,Boric
2021-12-05 05:24:46.923710,7256,646,False,910,686,278,530,48,174,285,2911,16,7,2934,15,15,100.0,Boric
2021-12-05 05:24:46.923710,7256,647,False,662,698,445,594,27,226,266,2918,24,19,2961,18,18,100.0,Kast
2021-12-05 05:24:46.923710,7392,1140,False,45,352,23,32,4,17,16,489,2,7,498,4,4,100.0,Kast
2021-12-05 05:24:46.923710,7652,2656,False,102,226,80,36,6,14,42,506,1,3,510,3,3,100.0,Kast
2021-12-05 05:24:46.923710,7606,1274,False,211,510,164,118,5,70,139,1217,11,13,1241,7,7,100.0,Kast
2021-12-05 05:24:46.923710,7736,1465,False,149,176,154,117,8,40,84,728,4,11,743,6,6,100.0,Kast
2021-12-05 05:24:46.923710,7316,2767,False,238,1115,183,262,13,104,209,2124,17,14,2155,15,15,100.0,Kast
2021-12-05 05:24:46.923710,7316,2768,False,189,1010,172,264,17,94,164,1910,12,14,1936,13,13,100.0,Kast
2021-12-05 05:24:46.923710,7209,2342,False,972,929,249,496,35,200,233,3114,17,15,3146,20,20,100.0,Boric
2021-12-05 05:24:46.923710,7209,2343,False,839,1081,453,649,41,305,182,3550,23,7,3580,23,23,100.0,Kast
2021-12-05 05:24:46.923710,7209,2344,False,598,735,369,385,25,198,119,2429,20,11,2460,17,17,100.0,Kast
2021-12-05 05:24:46.923710,7713,45,False,13,31,25,10,2,9,59,149,4,1,154,1,1,100.0,Parisi
2021-12-05 05:24:46.923710,7411,1229,False,392,1042,254,243,18,156,254,2359,13,4,2376,14,14,100.0,Kast
2021-12-05 05:24:46.923710,7411,1230,False,346,983,322,189,22,124,225,2211,24,17,2252,17,17,100.0,Kast
2021-12-05 05:24:46.923710,7411,1231,False,319,997,321,262,21,137,190,2247,13,7,2267,17,17,100.0,Kast
2021-12-05 05:24:46.923710,7411,1232,False,427,1046,238,197,16,112,366,2402,14,13,2429,16,16,100.0,Kast
2021-12-05 05:24:46.923710,7248,625,False,244,332,206,158,13,97,226,1276,8,8,1292,8,8,100.0,Kast
2021-12-05 05:24:46.923710,7248,626,False,399,645,516,422,34,185,410,2611,34,25,2670,17,17,100.0,Kast
2021-12-05 05:24:46.923710,7576,510,False,548,642,216,239,22,122,147,1936,18,5,1959,9,9,100.0,Kast
2021-12-05 05:24:46.923710,7576,511,False,1468,1333,399,626,70,320,474,4690,34,12,4736,23,23,100.0,Boric
2021-12-05 05:24:46.923710,7576,512,False,419,484,123,204,22,98,150,1500,8,2,1510,6,6,100.0,Kast
2021-12-05 05:24:46.923710,7576,513,False,1690,1296,401,681,74,290,467,4899,19,21,4939,20,20,100.0,Boric
2021-12-05 05:24:46.923710,7101,384,False,467,354,146,163,23,142,126,1421,9,1,1431,10,10,100.0,Boric
2021-12-05 05:24:46.923710,7101,385,False,702,607,186,208,67,191,172,2133,25,5,2163,15,15,100.0,Boric
2021-12-05 05:24:46.923710,7101,386,False,464,456,87,75,37,94,133,1346,8,2,1356,11,11,100.0,Boric
2021-12-05 05:24:46.923710,7101,387,False,1062,912,260,231,98,212,283,3058,31,8,3097,24,24,100.0,Boric
2021-12-05 05:24:46.923710,7101,388,False,248,266,46,55,22,57,85,779,8,2,789,8,8,100.0,Kast
2021-12-05 05:24:46.923710,7101,389,False,305,238,96,93,22,97,81,932,9,2,943,8,8,100.0,Boric
2021-12-05 05:24:46.923710,7101,390,False,377,298,141,104,27,110,116,1173,10,3,1186,9,9,100.0,Boric
2021-12-05 05:24:46.923710,7101,391,False,392,256,95,92,30,108,140,1113,9,3,1125,9,9,100.0,Boric
2021-12-05 05:24:46.923710,7101,392,False,678,665,254,271,62,243,332,2505,26,6,2537,20,20,100.0,Boric
2021-12-05 05:24:46.923710,7101,393,False,1107,766,360,232,75,247,268,3055,36,12,3103,24,24,100.0,Boric
2021-12-05 05:24:46.923710,7101,394,False,389,432,172,167,21,132,113,1426,16,6,1448,13,13,100.0,Kast
2021-12-05 05:24:46.923710,7101,395,False,842,681,273,219,69,211,229,2524,28,9,2561,20,20,100.0,Boric
2021-12-05 05:24:46.923710,7745,524,False,121,97,43,80,2,24,55,422,5,2,429,2,2,100.0,Boric
2021-12-05 05:24:46.923710,7190,2127,False,1340,629,343,599,38,89,42,3080,18,5,3103,15,15,100.0,Boric
2021-12-05 05:24:46.923710,7190,2135,False,1410,800,382,773,43,128,80,3616,19,4,3639,18,18,100.0,Boric
2021-12-05 05:24:46.923710,7190,2136,False,1324,847,401,742,53,142,72,3581,17,15,3613,18,18,100.0,Boric
2021-12-05 05:24:46.923710,7190,2129,False,935,589,277,430,38,73,30,2372,9,5,2386,12,12,100.0,Boric
2021-12-05 05:24:46.923710,7190,2128,False,1729,1077,474,955,57,178,83,4553,23,7,4583,24,24,100.0,Boric
2021-12-05 05:24:46.923710,7190,2130,False,888,455,221,403,46,63,46,2122,15,6,2143,10,10,100.0,Boric
2021-12-05 05:24:46.923710,7190,2131,False,1481,1014,396,888,55,129,93,4056,21,9,4086,22,22,100.0,Boric
2021-12-05 05:24:46.923710,7190,2132,False,1050,882,380,687,39,109,65,3212,16,11,3239,18,18,100.0,Boric
2021-12-05 05:24:46.923710,7190,2133,False,1207,983,369,763,55,129,87,3593,21,11,3625,21,21,100.0,Boric
2021-12-05 05:24:46.923710,7190,2134,False,1278,867,400,612,57,118,62,3394,17,6,3417,18,18,100.0,Boric
2021-12-05 05:24:46.923710,7188,2102,False,1993,1025,445,922,77,140,86,4688,18,13,4719,22,22,100.0,Boric
2021-12-05 05:24:46.923710,7188,2103,False,1785,1006,396,601,50,106,67,4011,15,7,4033,18,18,100.0,Boric
2021-12-05 05:24:46.923710,7188,2105,False,1090,515,199,424,37,58,60,2383,16,8,2407,12,12,100.0,Boric
2021-12-05 05:24:46.923710,7188,2104,False,1189,913,361,677,42,135,52,3369,13,14,3396,21,21,100.0,Boric
2021-12-05 05:24:46.923710,7188,2114,False,1123,833,314,519,43,126,86,3044,17,9,3070,16,16,100.0,Boric
2021-12-05 05:24:46.923710,7188,2106,False,1673,509,211,567,35,86,73,3154,11,5,3170,12,12,100.0,Boric
2021-12-05 05:24:46.923710,7188,2107,False,1136,861,338,655,57,161,83,3291,18,7,3316,17,17,100.0,Boric
2021-12-05 05:24:46.923710,7188,2108,False,1336,683,304,603,42,119,74,3161,11,8,3180,14,14,100.0,Boric
2021-12-05 05:24:46.923710,7188,2109,False,1121,718,276,547,49,135,108,2954,19,4,2977,16,16,100.0,Boric
2021-12-05 05:24:46.923710,7188,2110,False,1973,1052,394,919,85,190,164,4777,24,11,4812,24,24,100.0,Boric
2021-12-05 05:24:46.923710,7188,2111,False,2001,1119,562,1005,65,174,74,5000,21,13,5034,24,24,100.0,Boric
2021-12-05 05:24:46.923710,7188,2112,False,835,694,262,476,49,127,46,2489,18,7,2514,16,16,100.0,Boric
2021-12-05 05:24:46.923710,7188,2113,False,1102,903,395,606,42,164,74,3286,12,8,3306,16,16,100.0,Boric
2021-12-05 05:24:46.923710,7188,2115,False,1327,722,342,615,60,127,74,3267,21,9,3297,15,15,100.0,Boric
2021-12-05 05:24:46.923710,7304,811,False,17,157,29,65,2,24,15,309,5,9,323,2,2,100.0,Kast
2021-12-05 05:24:46.923710,7604,1064,False,65,138,100,53,9,42,70,477,10,11,498,4,4,100.0,Kast
2021-12-05 05:24:46.923710,7326,2786,False,169,559,262,185,13,54,107,1349,20,11,1380,12,12,100.0,Kast
2021-12-05 05:24:46.923710,7326,2787,False,139,509,312,186,10,62,100,1318,9,11,1338,11,11,100.0,Kast
2021-12-05 05:24:46.923710,7510,1552,False,318,264,106,59,7,85,111,950,13,7,970,9,9,100.0,Boric
2021-12-05 05:24:46.923710,7510,1553,False,443,317,198,107,11,108,134,1318,26,12,1356,11,11,100.0,Boric
2021-12-05 05:24:46.923710,7014,33,False,124,305,145,48,14,58,477,1171,8,7,1186,13,13,100.0,Parisi
2021-12-05 05:24:46.923710,7014,31,False,138,403,163,71,15,93,711,1594,20,6,1620,14,14,100.0,Parisi
2021-12-05 05:24:46.923710,7014,32,False,104,346,175,52,8,50,574,1309,8,9,1326,13,13,100.0,Parisi
2021-12-05 05:24:46.923710,7511,1554,False,63,66,43,31,4,46,51,304,7,2,313,4,4,100.0,Kast
2021-12-05 05:24:46.923710,7198,2190,False,1048,1261,386,893,29,84,58,3759,14,6,3779,20,20,100.0,Kast
2021-12-05 05:24:46.923710,7198,2191,False,1081,1223,358,883,43,83,52,3723,20,7,3750,20,20,100.0,Kast
2021-12-05 05:24:46.923710,7198,2192,False,1223,1216,355,888,40,98,47,3867,16,7,3890,20,20,100.0,Boric
2021-12-05 05:24:46.923710,7198,2193,False,1182,1262,457,821,37,102,57,3918,19,10,3947,20,20,100.0,Kast
2021-12-05 05:24:46.923710,7198,2194,False,1130,701,334,739,24,59,53,3040,9,7,3056,15,15,100.0,Boric
2021-12-05 05:24:46.923710,7198,2214,False,1813,925,303,825,44,67,63,4040,12,4,4056,15,15,100.0,Boric
2021-12-05 05:24:46.923710,7198,2195,False,1401,1376,486,948,39,97,58,4405,28,6,4439,19,19,100.0,Boric
2021-12-05 05:24:46.923710,7198,2196,False,1583,1467,590,1118,55,110,73,4996,26,10,5032,21,21,100.0,Boric
2021-12-05 05:24:46.923710,7198,2197,False,1786,1612,628,1330,37,114,44,5551,22,8,5581,24,24,100.0,Boric
2021-12-05 05:24:46.923710,7198,2199,False,1424,1636,580,1130,34,100,48,4952,16,7,4975,24,24,100.0,Kast
2021-12-05 05:24:46.923710,7198,2200,False,1825,1470,665,1334,44,102,56,5496,13,6,5515,24,24,100.0,Boric
2021-12-05 05:24:46.923710,7198,2201,False,563,797,275,516,16,48,31,2246,12,5,2263,16,16,100.0,Kast
2021-12-05 05:24:46.923710,7198,2202,False,1020,1137,353,834,30,82,54,3510,10,9,3529,23,23,100.0,Kast
2021-12-05 05:24:46.923710,7198,2203,False,946,1265,398,832,23,86,46,3596,17,5,3618,23,23,100.0,Kast
2021-12-05 05:24:46.923710,7198,2198,False,1367,1405,361,1077,43,95,94,4442,33,14,4489,24,24,100.0,Kast
2021-12-05 05:24:46.923710,7198,2204,False,914,1048,334,780,24,72,53,3225,15,9,3249,18,18,100.0,Kast
2021-12-05 05:24:46.923710,7198,2205,False,874,1095,299,777,24,68,50,3187,14,6,3207,18,18,100.0,Kast
2021-12-05 05:24:46.923710,7198,2206,False,719,1071,337,697,19,78,54,2975,12,11,2998,18,18,100.0,Kast
2021-12-05 05:24:46.923710,7198,2207,False,1365,1424,506,1078,49,114,59,4595,20,19,4634,23,23,100.0,Kast
2021-12-05 05:24:46.923710,7198,2208,False,1478,1409,571,968,51,80,48,4605,25,9,4639,20,20,100.0,Boric
2021-12-05 05:24:46.923710,7198,2209,False,1278,1309,468,899,41,78,51,4124,18,11,4153,19,19,100.0,Kast
2021-12-05 05:24:46.923710,7198,2212,False,502,711,184,451,17,40,23,1928,14,3,1945,15,15,100.0,Kast
2021-12-05 05:24:46.923710,7198,2215,False,447,633,177,430,16,40,22,1765,6,3,1774,13,13,100.0,Kast
2021-12-05 05:24:46.923710,7198,2210,False,715,952,325,672,21,56,29,2770,11,8,2789,18,18,100.0,Kast
2021-12-05 05:24:46.923710,7198,2211,False,736,969,316,719,15,72,49,2876,8,2,2886,18,18,100.0,Kast
2021-12-05 05:24:46.923710,7198,2213,False,582,849,267,557,18,38,30,2341,6,4,2351,20,20,100.0,Kast
2021-12-05 05:24:46.923710,7755,1304,False,130,432,161,59,11,52,72,917,10,16,943,8,8,100.0,Kast
2021-12-05 05:24:46.923710,7111,451,False,513,564,229,352,31,193,319,2201,16,5,2222,19,19,100.0,Kast
2021-12-05 05:24:46.923710,7111,452,False,473,511,217,429,22,165,338,2155,19,9,2183,18,18,100.0,Kast
2021-12-05 05:24:46.923710,7111,453,False,156,138,35,99,5,30,93,556,4,1,561,5,5,100.0,Boric
2021-12-05 05:24:46.923710,7408,1209,False,634,831,153,308,32,104,191,2253,15,3,2271,12,12,100.0,Kast
2021-12-05 05:24:46.923710,7408,1210,False,315,833,252,220,21,93,145,1879,19,17,1915,16,16,100.0,Kast
2021-12-05 05:24:46.923710,7408,1211,False,319,869,241,323,15,100,169,2036,17,15,2068,16,16,100.0,Kast
2021-12-05 05:24:46.923710,7408,1212,False,741,692,147,299,28,116,235,2258,13,10,2281,13,13,100.0,Boric
2021-12-05 05:24:46.923710,7408,1213,False,536,633,128,237,18,97,376,2025,16,7,2048,16,16,100.0,Kast
2021-12-05 05:24:46.923710,7408,1214,False,355,735,168,208,22,85,236,1809,13,5,1827,13,13,100.0,Kast
2021-12-05 05:24:46.923710,7154,1800,False,1057,804,370,355,102,540,429,3657,30,16,3703,24,24,100.0,Boric
2021-12-05 05:24:46.923710,7154,1801,False,1012,366,178,206,97,304,360,2523,41,7,2571,20,20,100.0,Boric
2021-12-05 05:24:46.923710,7154,1802,False,559,365,242,201,49,275,160,1851,17,7,1875,13,13,100.0,Boric
2021-12-05 05:24:46.923710,7154,1814,False,551,347,245,217,49,249,160,1818,21,10,1849,13,13,100.0,Boric
2021-12-05 05:24:46.923710,7154,1803,False,722,255,93,141,61,218,356,1846,18,2,1866,14,14,100.0,Boric
2021-12-05 05:24:46.923710,7154,1815,False,731,217,74,117,56,204,328,1727,12,8,1747,13,13,100.0,Boric
2021-12-05 05:24:46.923710,7154,1804,False,1068,632,428,351,90,519,291,3379,30,22,3431,24,24,100.0,Boric
2021-12-05 05:24:46.923710,7154,1805,False,688,422,208,158,62,216,245,1999,13,3,2015,13,13,100.0,Boric
2021-12-05 05:24:46.923710,7154,1816,False,651,297,129,136,53,211,323,1800,10,7,1817,13,13,100.0,Boric
2021-12-05 05:24:46.923710,7154,1806,False,982,681,479,394,78,556,287,3457,40,29,3526,24,24,100.0,Boric
2021-12-05 05:24:46.923710,7154,1807,False,925,642,416,415,74,560,263,3295,28,12,3335,24,24,100.0,Boric
2021-12-05 05:24:46.923710,7154,1808,False,812,559,320,342,48,466,306,2853,24,10,2887,20,20,100.0,Boric
2021-12-05 05:24:46.923710,7154,1809,False,809,545,260,319,54,396,289,2672,16,4,2692,18,18,100.0,Boric
2021-12-05 05:24:46.923710,7154,1810,False,874,519,294,309,72,457,382,2907,29,2,2938,18,18,100.0,Boric
2021-12-05 05:24:46.923710,7154,1811,False,798,572,386,407,101,431,213,2908,24,25,2957,24,24,100.0,Boric
2021-12-05 05:24:46.923710,7154,1812,False,815,571,350,342,60,451,314,2903,14,8,2925,22,22,100.0,Boric
2021-12-05 05:24:46.923710,7154,1813,False,1040,709,494,362,58,505,350,3518,36,19,3573,24,24,100.0,Boric
2021-12-05 05:24:46.923710,7591,2476,False,1813,756,370,450,119,473,448,4429,40,10,4479,22,22,100.0,Boric
2021-12-05 05:24:46.923710,7591,2477,False,1212,564,192,293,91,391,532,3275,24,8,3307,19,19,100.0,Boric
2021-12-05 05:24:46.923710,7591,2478,False,1525,497,181,295,120,361,555,3534,26,10,3570,20,20,100.0,Boric
2021-12-05 05:24:46.923710,7591,2480,False,903,608,285,314,79,357,313,2859,9,3,2871,16,16,100.0,Boric
2021-12-05 05:24:46.923710,7591,2481,False,853,488,203,270,55,365,339,2573,12,4,2589,16,16,100.0,Boric
2021-12-05 05:24:46.923710,7591,2482,False,1056,610,446,423,75,476,184,3270,32,10,3312,17,17,100.0,Boric
2021-12-05 05:24:46.923710,7591,2479,False,1214,747,504,347,70,395,256,3533,20,6,3559,18,18,100.0,Boric
2021-12-05 05:24:46.923710,7591,2483,False,1060,553,412,423,63,468,215,3194,20,4,3218,16,16,100.0,Boric
2021-12-05 05:24:46.923710,7591,2484,False,1617,683,275,410,117,429,425,3956,36,6,3998,21,21,100.0,Boric
2021-12-05 05:24:46.923710,7603,2803,False,239,789,296,263,15,120,185,1907,25,23,1955,12,12,100.0,Kast
2021-12-05 05:24:46.923710,7455,1345,False,105,279,93,92,7,37,61,674,7,15,696,5,5,100.0,Kast
2021-12-05 05:24:46.923710,7207,2284,False,736,445,374,264,31,273,141,2264,25,15,2304,15,15,100.0,Boric
2021-12-05 05:24:46.923710,7207,2334,False,797,453,307,308,39,299,148,2351,26,13,2390,15,15,100.0,Boric
2021-12-05 05:24:46.923710,7207,2301,False,1073,570,343,493,46,390,200,3115,17,12,3144,18,18,100.0,Boric
2021-12-05 05:24:46.923710,7207,2302,False,1216,564,343,488,44,369,200,3224,21,7,3252,18,18,100.0,Boric
2021-12-05 05:24:46.923710,7207,2324,False,767,446,149,263,44,238,314,2221,11,2,2234,18,18,100.0,Boric
2021-12-05 05:24:46.923710,7207,2285,False,1541,887,395,483,110,414,356,4186,32,5,4223,23,23,100.0,Boric
2021-12-05 05:24:46.923710,7207,2286,False,978,589,236,370,65,384,365,2987,32,8,3027,24,24,100.0,Boric
2021-12-05 05:24:46.923710,7207,2287,False,912,595,227,371,59,325,308,2797,20,3,2820,23,23,100.0,Boric
2021-12-05 05:24:46.923710,7207,2289,False,1009,336,139,257,68,271,351,2431,9,2,2442,18,18,100.0,Boric
2021-12-05 05:24:46.923710,7207,2290,False,984,345,126,205,64,278,371,2373,9,4,2386,18,18,100.0,Boric
2021-12-05 05:24:46.923710,7207,2292,False,813,230,91,137,55,168,223,1717,12,6,1735,13,13,100.0,Boric
2021-12-05 05:24:46.923710,7207,2341,False,626,274,120,172,45,189,209,1635,16,0,1651,13,13,100.0,Boric
2021-12-05 05:24:46.923710,7207,2299,False,978,281,104,201,64,218,335,2181,22,11,2214,16,16,100.0,Boric
2021-12-05 05:24:46.923710,7207,2296,False,938,567,321,341,44,374,251,2836,19,11,2866,18,18,100.0,Boric
2021-12-05 05:24:46.923710,7207,2297,False,981,608,350,334,52,342,272,2939,21,8,2968,18,18,100.0,Boric
2021-12-05 05:24:46.923710,7207,2298,False,1391,508,241,344,87,344,340,3255,29,13,3297,24,24,100.0,Boric
2021-12-05 05:24:46.923710,7207,2288,False,593,369,140,203,29,223,239,1796,8,1,1805,14,14,100.0,Boric
2021-12-05 05:24:46.923710,7207,2335,False,610,339,134,199,37,204,256,1779,13,3,1795,14,14,100.0,Boric
2021-12-05 05:24:46.923710,7207,2300,False,1442,469,229,320,64,315,398,3237,26,7,3270,24,24,100.0,Boric
2021-12-05 05:24:46.923710,7207,2303,False,864,502,339,418,54,347,218,2742,16,6,2764,18,18,100.0,Boric
2021-12-05 05:24:46.923710,7207,2304,False,992,562,359,411,33,342,218,2917,21,6,2944,18,18,100.0,Boric
2021-12-05 05:24:46.923710,7207,2331,False,966,407,152,254,52,251,393,2475,10,6,2491,20,20,100.0,Boric
2021-12-05 05:24:46.923710,7207,2291,False,765,266,104,177,30,198,278,1818,9,3,1830,14,14,100.0,Boric
2021-12-05 05:24:46.923710,7207,2336,False,671,252,94,160,41,216,292,1726,8,2,1736,14,14,100.0,Boric
2021-12-05 05:24:46.923710,7207,2293,False,877,497,349,432,57,373,211,2796,29,6,2831,18,18,100.0,Boric
2021-12-05 05:24:46.923710,7207,2294,False,919,541,363,461,50,413,203,2950,30,8,2988,18,18,100.0,Boric
2021-12-05 05:24:46.923710,7207,2312,False,846,323,190,224,44,186,162,1975,14,3,1992,12,12,100.0,Boric
2021-12-05 05:24:46.923710,7207,2329,False,760,389,133,215,52,236,282,2067,14,1,2082,18,18,100.0,Boric
2021-12-05 05:24:46.923710,7207,2305,False,825,530,440,313,40,333,177,2658,39,20,2717,18,18,100.0,Boric
2021-12-05 05:24:46.923710,7207,2306,False,863,565,428,333,55,356,176,2776,28,19,2823,18,18,100.0,Boric
2021-12-05 05:24:46.923710,7207,2307,False,1435,482,178,327,120,336,515,3393,31,5,3429,24,24,100.0,Boric
2021-12-05 05:24:46.923710,7207,2308,False,526,346,201,265,31,231,111,1711,29,7,1747,14,14,100.0,Boric
2021-12-05 05:24:46.923710,7207,2337,False,593,377,220,277,32,277,111,1887,15,7,1909,14,14,100.0,Boric
2021-12-05 05:24:46.923710,7207,2295,False,1269,289,103,237,78,271,351,2598,25,5,2628,18,18,100.0,Boric
2021-12-05 05:24:46.923710,7207,2309,False,741,514,314,368,34,349,143,2463,19,6,2488,18,18,100.0,Boric
2021-12-05 05:24:46.923710,7207,2310,False,741,559,350,413,39,373,194,2669,26,11,2706,18,18,100.0,Boric
2021-12-05 05:24:46.923710,7207,2311,False,655,421,309,269,40,263,122,2079,30,9,2118,15,15,100.0,Boric
2021-12-05 05:24:46.923710,7207,2338,False,593,399,259,267,38,249,128,1933,13,7,1953,14,14,100.0,Boric
2021-12-05 05:24:46.923710,7207,2313,False,796,453,258,327,39,296,175,2344,13,2,2359,14,14,100.0,Boric
2021-12-05 05:24:46.923710,7207,2339,False,791,508,277,351,33,287,168,2415,17,9,2441,14,14,100.0,Boric
2021-12-05 05:24:46.923710,7207,2314,False,1101,378,134,259,59,304,344,2579,19,2,2600,18,18,100.0,Boric
2021-12-05 05:24:46.923710,7207,2315,False,932,358,149,269,56,257,395,2416,10,3,2429,18,18,100.0,Boric
2021-12-05 05:24:46.923710,7207,2316,False,1045,705,397,367,82,381,253,3230,33,12,3275,20,20,100.0,Boric
2021-12-05 05:24:46.923710,7207,2317,False,1209,746,382,405,69,328,258,3397,29,10,3436,20,20,100.0,Boric
2021-12-05 05:24:46.923710,7207,2318,False,1238,365,137,252,88,268,412,2760,18,6,2784,21,21,100.0,Boric
2021-12-05 05:24:46.923710,7207,2332,False,728,278,119,184,36,210,270,1825,18,3,1846,14,14,100.0,Boric
2021-12-05 05:24:46.923710,7207,2333,False,645,277,96,182,40,197,297,1734,9,3,1746,13,13,100.0,Boric
2021-12-05 05:24:46.923710,7207,2330,False,747,354,121,207,37,220,302,1988,14,2,2004,18,18,100.0,Boric
2021-12-05 05:24:46.923710,7207,2319,False,922,532,357,338,55,347,220,2771,17,13,2801,18,18,100.0,Boric
2021-12-05 05:24:46.923710,7207,2320,False,928,580,348,343,47,367,248,2861,24,8,2893,18,18,100.0,Boric
2021-12-05 05:24:46.923710,7207,2321,False,836,519,347,451,45,335,189,2722,35,8,2765,18,18,100.0,Boric
2021-12-05 05:24:46.923710,7207,2322,False,861,493,323,437,45,373,182,2714,28,5,2747,18,18,100.0,Boric
2021-12-05 05:24:46.923710,7207,2323,False,771,459,228,377,45,298,172,2350,30,6,2386,14,14,100.0,Boric
2021-12-05 05:24:46.923710,7207,2340,False,986,456,239,374,58,270,175,2558,14,5,2577,14,14,100.0,Boric
2021-12-05 05:24:46.923710,7207,2325,False,833,531,338,384,41,367,151,2645,30,7,2682,18,18,100.0,Boric
2021-12-05 05:24:46.923710,7207,2326,False,847,569,323,400,47,365,163,2714,18,10,2742,18,18,100.0,Boric
2021-12-05 05:24:46.923710,7207,2327,False,650,382,299,269,45,220,153,2018,26,22,2066,18,18,100.0,Boric
2021-12-05 05:24:46.923710,7207,2328,False,724,494,348,280,38,263,136,2283,41,18,2342,18,18,100.0,Boric
2021-12-05 05:24:46.923710,7623,673,False,299,447,168,194,10,89,221,1428,15,8,1451,11,11,100.0,Kast
2021-12-05 05:24:46.923710,7642,2805,False,142,278,171,92,5,72,123,883,7,7,897,5,5,100.0,Kast
2021-12-05 05:24:46.923710,7492,1491,False,72,48,28,20,4,20,34,226,3,8,237,3,3,100.0,Boric
2021-12-05 05:24:46.923710,7592,1507,False,78,123,69,29,4,32,96,431,12,6,449,3,3,100.0,Kast
2021-12-05 05:24:46.923710,7419,1247,False,101,396,231,117,22,74,94,1035,16,19,1070,7,7,100.0,Kast
2021-12-05 05:24:46.923710,7553,1558,False,7,21,2,0,0,1,1,32,0,2,34,1,1,100.0,Kast
2021-12-05 05:24:46.923710,7498,1497,False,75,97,68,42,4,11,20,317,5,3,325,3,3,100.0,Kast
2021-12-05 05:24:46.923710,7708,1447,False,583,1029,325,351,26,204,463,2981,20,12,3013,21,21,100.0,Kast
2021-12-05 05:24:46.923710,7708,1448,False,566,997,345,317,29,177,407,2838,22,14,2874,21,21,100.0,Kast
2021-12-05 05:24:46.923710,7708,1449,False,596,996,302,313,34,171,427,2839,9,7,2855,20,20,100.0,Kast
2021-12-05 05:24:46.923710,7708,1450,False,436,752,218,233,26,137,298,2100,17,7,2124,15,15,100.0,Kast
2021-12-05 05:24:46.923710,7708,1451,False,618,1023,354,320,38,174,464,2991,23,16,3030,21,21,100.0,Kast
2021-12-05 05:24:46.923710,7708,1452,False,584,980,299,337,32,179,415,2826,16,10,2852,20,20,100.0,Kast
2021-12-05 05:24:46.923710,7708,1453,False,607,1077,360,392,41,194,465,3136,25,17,3178,21,21,100.0,Kast
2021-12-05 05:24:46.923710,7708,1454,False,603,1052,344,363,45,171,466,3044,32,16,3092,21,21,100.0,Kast
2021-12-05 05:24:46.923710,7708,1455,False,572,1028,347,346,46,167,470,2976,17,22,3015,21,21,100.0,Kast
2021-12-05 05:24:46.923710,7708,1456,False,588,1040,317,307,28,178,403,2861,19,22,2902,21,21,100.0,Kast
2021-12-05 05:24:46.923710,7708,1457,False,637,993,311,359,40,182,437,2959,19,11,2989,21,21,100.0,Kast
2021-12-05 05:24:46.923710,7707,1439,False,999,913,209,312,66,211,659,3369,26,8,3403,18,18,100.0,Boric
2021-12-05 05:24:46.923710,7707,1440,False,721,838,270,275,52,179,550,2885,18,17,2920,18,18,100.0,Kast
2021-12-05 05:24:46.923710,7707,1441,False,586,958,314,320,45,196,504,2923,23,19,2965,18,18,100.0,Kast
2021-12-05 05:24:46.923710,7707,1442,False,616,847,331,264,50,151,477,2736,20,8,2764,18,18,100.0,Kast
2021-12-05 05:24:46.923710,7707,1443,False,594,951,322,301,39,162,507,2876,16,15,2907,18,18,100.0,Kast
2021-12-05 05:24:46.923710,7707,1444,False,636,1001,327,322,33,199,553,3071,25,13,3109,19,19,100.0,Kast
2021-12-05 05:24:46.923710,7707,1445,False,646,923,298,303,46,181,537,2934,23,18,2975,19,19,100.0,Kast
2021-12-05 05:24:46.923710,7707,1446,False,629,939,390,330,41,182,575,3086,28,13,3127,19,19,100.0,Kast
2021-12-05 05:24:46.923710,7709,1458,False,1178,1146,307,548,58,168,426,3831,28,4,3863,18,18,100.0,Boric
2021-12-05 05:24:46.923710,7709,1459,False,527,913,297,291,31,155,309,2523,10,11,2544,14,14,100.0,Kast
2021-12-05 05:24:46.923710,7709,1460,False,675,1049,313,348,37,198,430,3050,23,17,3090,18,18,100.0,Kast
2021-12-05 05:24:46.923710,7709,1461,False,840,1131,368,401,37,180,460,3417,17,19,3453,19,19,100.0,Kast
2021-12-05 05:24:46.923710,7709,1462,False,725,1221,399,412,51,241,420,3469,21,23,3513,19,19,100.0,Kast
2021-12-05 05:24:46.923710,7685,2668,False,57,248,119,76,4,20,41,565,3,4,572,4,4,100.0,Kast
2021-12-05 05:24:46.923710,7447,1329,False,236,490,413,134,18,84,259,1634,10,10,1654,12,12,100.0,Kast
2021-12-05 05:24:46.923710,7447,1330,False,346,617,461,151,16,84,289,1964,16,15,1995,15,15,100.0,Kast
2021-12-05 05:24:46.923710,7453,1343,False,662,1696,533,530,40,188,343,3992,28,35,4055,25,25,100.0,Kast
2021-12-05 05:24:46.923710,7453,1339,False,1361,1983,330,1215,29,158,355,5431,31,15,5477,25,25,100.0,Kast
2021-12-05 05:24:46.923710,7453,1340,False,576,1266,286,544,25,113,261,3071,12,10,3093,15,15,100.0,Kast
2021-12-05 05:24:46.923710,7453,1341,False,883,1817,335,696,47,160,575,4513,20,20,4553,25,25,100.0,Kast
2021-12-05 05:24:46.923710,7453,1342,False,586,1724,483,622,36,199,340,3990,27,19,4036,25,25,100.0,Kast
2021-12-05 05:24:46.923710,7746,525,False,202,168,218,119,6,57,126,896,5,3,904,5,5,100.0,Provoste
2021-12-05 05:24:46.923710,7253,640,False,356,534,383,346,27,133,125,1904,8,17,1929,13,13,100.0,Kast
2021-12-05 05:24:46.923710,7063,235,False,555,470,520,225,19,203,926,2918,36,34,2988,23,23,100.0,Parisi
2021-12-05 05:24:46.923710,7063,234,False,264,212,189,71,12,59,318,1125,8,11,1144,9,9,100.0,Parisi
2021-12-05 05:24:46.923710,7505,1519,False,434,570,124,117,16,102,191,1554,16,2,1572,10,10,100.0,Kast
2021-12-05 05:24:46.923710,7505,1520,False,464,389,120,151,21,134,195,1474,17,4,1495,12,12,100.0,Boric
2021-12-05 05:24:46.923710,7505,1521,False,404,371,81,126,16,123,184,1305,14,8,1327,10,10,100.0,Boric
2021-12-05 05:24:46.923710,7505,1522,False,509,385,128,160,16,175,239,1612,10,4,1626,10,10,100.0,Boric
2021-12-05 05:24:46.923710,7505,1523,False,841,554,204,186,25,250,379,2439,25,8,2472,15,15,100.0,Boric
2021-12-05 05:24:46.923710,7505,1524,False,741,705,214,235,15,209,264,2383,18,3,2404,15,15,100.0,Boric
2021-12-05 05:24:46.923710,7505,1525,False,674,700,157,153,34,132,283,2133,17,7,2157,16,16,100.0,Kast
2021-12-05 05:24:46.923710,7505,1526,False,630,618,247,216,14,266,273,2264,23,5,2292,15,15,100.0,Boric
2021-12-05 05:24:46.923710,7505,1527,False,531,365,126,126,8,149,256,1561,13,7,1581,10,10,100.0,Boric
2021-12-05 05:24:46.923710,7505,1528,False,580,658,120,145,23,155,258,1939,15,4,1958,16,16,100.0,Kast
2021-12-05 05:24:46.923710,7505,1529,False,504,468,115,114,24,92,278,1595,16,2,1613,12,12,100.0,Boric
2021-12-05 05:24:46.923710,7505,1530,False,535,568,142,125,20,146,234,1770,12,9,1791,15,15,100.0,Kast
2021-12-05 05:24:46.923710,7505,1531,False,537,423,152,142,15,188,260,1717,9,3,1729,12,12,100.0,Boric
2021-12-05 05:24:46.923710,7505,1532,False,715,579,253,192,16,243,308,2306,18,8,2332,15,15,100.0,Boric
2021-12-05 05:24:46.923710,7505,1533,False,758,534,223,156,31,191,255,2148,17,5,2170,15,15,100.0,Boric
2021-12-05 05:24:46.923710,7505,1534,False,699,545,172,197,20,175,229,2037,16,8,2061,12,12,100.0,Boric
2021-12-05 05:24:46.923710,7505,1535,False,553,588,130,138,20,165,234,1828,18,11,1857,15,15,100.0,Kast
2021-12-05 05:24:46.923710,7505,1536,False,817,577,229,202,23,272,327,2447,22,10,2479,15,15,100.0,Boric
2021-12-05 05:24:46.923710,7505,1537,False,720,576,199,200,21,263,382,2361,18,11,2390,15,15,100.0,Boric
2021-12-05 05:24:46.923710,7505,1538,False,524,438,181,173,12,154,115,1597,8,3,1608,12,12,100.0,Boric
2021-12-05 05:24:46.923710,7505,1539,False,428,400,140,128,9,157,206,1468,16,3,1487,10,10,100.0,Boric
2021-12-05 05:24:46.923710,7505,1540,False,592,611,224,175,13,239,199,2053,20,10,2083,15,15,100.0,Kast
2021-12-05 05:24:46.923710,7505,1541,False,381,602,122,124,12,125,115,1481,11,5,1497,16,16,100.0,Kast
2021-12-05 05:24:46.923710,7505,1542,False,425,387,150,137,16,209,156,1480,12,7,1499,10,10,100.0,Boric
2021-12-05 05:24:46.923710,7505,1543,False,504,404,177,137,13,161,147,1543,12,6,1561,12,12,100.0,Boric
2021-12-05 05:24:46.923710,7505,1544,False,634,509,231,179,12,265,195,2025,22,7,2054,15,15,100.0,Boric
2021-12-05 05:24:46.923710,7505,1545,False,368,359,115,119,8,157,213,1339,12,5,1356,9,9,100.0,Boric
2021-12-05 05:24:46.923710,7505,1546,False,714,586,172,164,26,183,310,2155,11,16,2182,16,16,100.0,Boric
2021-12-05 05:24:46.923710,7505,1547,False,497,550,176,171,11,146,100,1651,19,5,1675,15,15,100.0,Kast
2021-12-05 05:24:46.923710,7505,1548,False,662,569,179,193,27,246,389,2265,17,7,2289,15,15,100.0,Boric
2021-12-05 05:24:46.923710,7728,1093,False,35,227,26,20,5,29,30,372,8,6,386,3,3,100.0,Kast
2021-12-05 05:24:46.923710,7476,1389,False,299,287,217,102,14,83,293,1295,23,12,1330,14,14,100.0,Boric
2021-12-05 05:24:46.923710,7393,1141,False,202,872,294,121,13,64,128,1694,14,14,1722,13,13,100.0,Kast
2021-12-05 05:24:46.923710,7393,1142,False,242,871,323,118,25,92,151,1822,13,7,1842,13,13,100.0,Kast
2021-12-05 05:24:46.923710,7393,1143,False,171,901,307,159,11,74,126,1749,17,11,1777,13,13,100.0,Kast
2021-12-05 05:24:46.923710,7448,1331,False,293,722,316,212,16,91,246,1896,22,14,1932,14,14,100.0,Kast
2021-12-05 05:24:46.923710,7448,1332,False,264,636,354,146,13,83,187,1683,24,22,1729,15,15,100.0,Kast
2021-12-05 05:24:46.923710,7448,1333,False,196,508,198,87,14,41,152,1196,13,7,1216,9,9,100.0,Kast
2021-12-05 05:24:46.923710,7448,1334,False,338,920,449,254,23,124,296,2404,27,25,2456,20,20,100.0,Kast
2021-12-05 05:24:46.923710,7084,299,False,912,712,505,339,51,276,429,3224,28,16,3268,21,21,100.0,Boric
2021-12-05 05:24:46.923710,7084,300,False,895,670,526,289,68,260,515,3223,36,20,3279,21,21,100.0,Boric
2021-12-05 05:24:46.923710,7004,2698,False,128,510,170,67,16,69,488,1448,18,17,1483,16,16,100.0,Kast
2021-12-05 05:24:46.923710,7287,760,False,270,366,398,144,19,83,316,1596,24,12,1632,13,13,100.0,Provoste
2021-12-05 05:24:46.923710,7446,1327,False,404,940,580,202,25,125,312,2588,25,25,2638,18,18,100.0,Kast
2021-12-05 05:24:46.923710,7446,1328,False,349,850,571,211,17,142,286,2426,20,13,2459,17,17,100.0,Kast
2021-12-05 05:24:46.923710,7494,1493,False,46,86,65,31,6,17,37,288,1,5,294,2,2,100.0,Kast
2021-12-05 05:24:46.923710,7466,1371,False,33,89,43,27,5,9,9,215,9,5,229,4,4,100.0,Kast
2021-12-05 05:24:46.923710,7478,1392,False,493,520,663,212,29,117,315,2349,20,34,2403,19,19,100.0,Provoste
2021-12-05 05:24:46.923710,7479,1393,False,370,330,167,81,20,76,409,1453,13,12,1478,14,14,100.0,Parisi
2021-12-05 05:24:46.923710,7479,1394,False,645,846,629,249,50,157,630,3206,50,61,3317,25,25,100.0,Kast
2021-12-05 05:24:46.923710,7479,1395,False,610,797,708,323,36,178,622,3274,37,50,3361,26,26,100.0,Kast
2021-12-05 05:24:46.923710,7469,1379,False,219,209,194,84,11,48,129,894,4,5,903,11,11,100.0,Boric
2021-12-05 05:24:46.923710,7469,1380,False,198,186,199,61,9,53,96,802,7,16,825,11,11,100.0,Provoste
2021-12-05 05:24:46.923710,7474,1387,False,44,13,44,8,1,6,14,130,1,13,144,2,2,100.0,Boric
2021-12-05 05:24:46.923710,7547,1406,False,37,191,70,39,5,13,43,398,5,4,407,4,4,100.0,Kast
2021-12-05 05:24:46.923710,7557,1266,False,324,750,396,252,56,151,194,2123,29,28,2180,17,17,100.0,Kast
2021-12-05 05:24:46.923710,7416,1242,False,122,411,152,138,14,90,152,1079,20,21,1120,8,8,100.0,Kast
2021-12-05 05:24:46.923710,7445,1326,False,182,253,346,77,15,37,98,1008,15,11,1034,6,6,100.0,Provoste
2021-12-05 05:24:46.923710,7364,1014,False,235,668,409,194,11,79,233,1829,13,26,1868,15,15,100.0,Kast
2021-12-05 05:24:46.923710,7149,1739,False,1129,772,462,380,72,387,381,3583,64,11,3658,19,19,100.0,Boric
2021-12-05 05:24:46.923710,7149,1738,False,957,610,395,425,45,478,337,3247,18,9,3274,18,18,100.0,Boric
2021-12-05 05:24:46.923710,7149,1740,False,998,419,147,260,79,279,547,2729,13,5,2747,17,17,100.0,Boric
2021-12-05 05:24:46.923710,7149,1741,False,1152,468,262,371,66,306,380,3005,14,7,3026,18,18,100.0,Boric
2021-12-05 05:24:46.923710,7149,1759,False,1433,759,345,489,72,432,472,4002,29,9,4040,21,21,100.0,Boric
2021-12-05 05:24:46.923710,7149,1742,False,1167,356,177,274,91,306,528,2899,21,4,2924,18,18,100.0,Boric
2021-12-05 05:24:46.923710,7149,1743,False,1233,385,152,306,90,247,434,2847,28,8,2883,17,17,100.0,Boric
2021-12-05 05:24:46.923710,7149,1744,False,620,510,228,280,37,267,347,2289,9,5,2303,16,16,100.0,Boric
2021-12-05 05:24:46.923710,7149,1745,False,604,419,137,213,33,272,416,2094,13,2,2109,15,15,100.0,Boric
2021-12-05 05:24:46.923710,7149,1746,False,1209,781,466,521,77,592,446,4092,35,13,4140,23,23,100.0,Boric
2021-12-05 05:24:46.923710,7149,1747,False,1352,657,304,410,99,365,418,3605,28,14,3647,23,23,100.0,Boric
2021-12-05 05:24:46.923710,7149,1748,False,908,743,432,488,57,432,270,3330,27,6,3363,21,21,100.0,Boric
2021-12-05 05:24:46.923710,7149,1749,False,1210,850,539,425,76,439,367,3906,25,11,3942,21,21,100.0,Boric
2021-12-05 05:24:46.923710,7149,1750,False,791,451,141,251,54,320,518,2526,20,2,2548,18,18,100.0,Boric
2021-12-05 05:24:46.923710,7149,1755,False,1062,736,483,510,67,572,332,3762,32,5,3799,21,21,100.0,Boric
2021-12-05 05:24:46.923710,7149,1751,False,990,623,416,472,49,457,297,3304,25,5,3334,19,19,100.0,Boric
2021-12-05 05:24:46.923710,7149,1752,False,837,599,315,316,57,336,232,2692,15,15,2722,16,16,100.0,Boric
2021-12-05 05:24:46.923710,7149,1753,False,791,537,383,308,46,300,220,2585,18,22,2625,16,16,100.0,Boric
2021-12-05 05:24:46.923710,7149,1754,False,818,567,361,355,49,371,245,2766,14,8,2788,16,16,100.0,Boric
2021-12-05 05:24:46.923710,7149,1756,False,725,282,142,199,54,221,244,1867,15,3,1885,13,13,100.0,Boric
2021-12-05 05:24:46.923710,7149,1760,False,727,302,149,192,49,188,222,1829,31,10,1870,13,13,100.0,Boric
2021-12-05 05:24:46.923710,7149,1757,False,804,624,242,323,49,315,329,2686,9,6,2701,16,16,100.0,Boric
2021-12-05 05:24:46.923710,7149,1758,False,1113,516,191,260,90,399,689,3258,154,6,3418,23,23,100.0,Boric
2021-12-05 05:24:46.923710,7069,248,False,440,389,392,197,19,124,218,1779,18,11,1808,13,13,100.0,Boric
2021-12-05 05:24:46.923710,7614,132,False,5,9,8,9,0,10,39,80,1,0,81,1,1,100.0,Parisi
2021-12-05 05:24:46.923710,7361,1009,False,296,1143,380,312,34,169,505,2839,43,33,2915,28,28,100.0,Kast
2021-12-05 05:24:46.923710,7323,2781,False,265,603,200,198,22,110,283,1681,21,12,1714,12,12,100.0,Kast
2021-12-05 05:24:46.923710,7323,2782,False,211,761,307,261,13,127,328,2008,18,5,2031,13,13,100.0,Kast
2021-12-05 05:24:46.923710,7323,2783,False,244,690,297,214,22,107,251,1825,13,10,1848,13,13,100.0,Kast
2021-12-05 05:24:46.923710,7089,309,False,778,753,264,344,58,265,510,2972,28,7,3007,18,18,100.0,Boric
2021-12-05 05:24:46.923710,7089,310,False,882,1101,358,561,41,349,623,3915,22,16,3953,24,24,100.0,Kast
2021-12-05 05:24:46.923710,7089,311,False,549,272,75,113,57,89,437,1592,16,5,1613,11,11,100.0,Boric
2021-12-05 05:24:46.923710,7089,312,False,932,730,174,321,52,199,521,2929,18,7,2954,18,18,100.0,Boric
2021-12-05 05:24:46.923710,7089,313,False,558,697,346,330,38,220,302,2491,27,11,2529,18,18,100.0,Kast
2021-12-05 05:24:46.923710,7089,314,False,535,813,309,412,34,253,281,2637,30,11,2678,19,19,100.0,Kast
2021-12-05 05:24:46.923710,7089,315,False,731,681,232,346,38,188,310,2526,22,4,2552,12,12,100.0,Boric
2021-12-05 05:24:46.923710,7089,316,False,770,877,306,410,46,267,485,3161,27,7,3195,18,18,100.0,Kast
2021-12-05 05:24:46.923710,7089,317,False,523,739,273,375,34,241,327,2512,25,12,2549,16,16,100.0,Kast
2021-12-05 05:24:46.923710,7089,320,False,513,664,283,285,32,221,337,2335,21,8,2364,14,14,100.0,Kast
2021-12-05 05:24:46.923710,7089,318,False,1249,1277,353,426,77,298,682,4362,21,12,4395,25,25,100.0,Kast
2021-12-05 05:24:46.923710,7089,319,False,677,772,321,336,29,210,452,2797,23,11,2831,17,17,100.0,Kast
2021-12-05 05:24:46.923710,7112,454,False,1152,957,345,479,57,288,431,3709,19,13,3741,21,21,100.0,Boric
2021-12-05 05:24:46.923710,7112,455,False,1503,1633,383,522,69,309,447,4866,20,10,4896,23,23,100.0,Kast
2021-12-05 05:24:46.923710,7112,456,False,401,379,149,146,19,110,113,1317,8,6,1331,10,10,100.0,Boric
2021-12-05 05:24:46.923710,7112,457,False,1537,1513,608,700,76,500,613,5547,43,26,5616,32,32,100.0,Boric
2021-12-05 05:24:46.923710,7112,458,False,1239,1510,556,685,64,445,460,4959,32,15,5006,33,33,100.0,Kast
2021-12-05 05:24:46.923710,7112,466,False,1352,1306,389,548,59,336,444,4434,37,7,4478,27,27,100.0,Boric
2021-12-05 05:24:46.923710,7112,459,False,959,1030,363,509,52,327,358,3598,28,9,3635,22,22,100.0,Kast
2021-12-05 05:24:46.923710,7112,460,False,1877,1930,567,897,82,493,593,6439,49,15,6503,30,30,100.0,Kast
2021-12-05 05:24:46.923710,7112,461,False,687,547,182,262,33,164,302,2177,21,5,2203,12,12,100.0,Boric
2021-12-05 05:24:46.923710,7112,462,False,1162,1207,336,498,63,321,504,4091,34,7,4132,22,22,100.0,Kast
2021-12-05 05:24:46.923710,7112,463,False,1435,1691,420,530,70,334,556,5036,32,16,5084,26,26,100.0,Kast
2021-12-05 05:24:46.923710,7112,464,False,1393,1236,417,711,60,424,598,4839,41,12,4892,30,30,100.0,Boric
2021-12-05 05:24:46.923710,7112,465,False,1288,1024,440,446,62,360,540,4160,21,21,4202,25,25,100.0,Boric
2021-12-05 05:24:46.923710,7309,2751,False,155,430,182,128,9,79,133,1116,9,17,1142,9,9,100.0,Kast
2021-12-05 05:24:46.923710,7473,1385,False,308,203,267,82,6,56,118,1040,11,4,1055,12,12,100.0,Boric
2021-12-05 05:24:46.923710,7473,1386,False,306,224,238,66,15,34,100,983,9,11,1003,11,11,100.0,Boric
2021-12-05 05:24:46.923710,7756,1305,False,36,187,44,31,5,22,23,348,2,4,354,3,3,100.0,Kast
2021-12-05 05:24:46.923710,7236,587,False,812,756,380,363,36,203,424,2974,35,36,3045,20,20,100.0,Boric
2021-12-05 05:24:46.923710,7236,588,False,652,685,402,421,36,217,386,2799,25,23,2847,17,17,100.0,Kast
2021-12-05 05:24:46.923710,7152,1783,False,1292,677,369,447,71,388,195,3439,27,13,3479,19,19,100.0,Boric
2021-12-05 05:24:46.923710,7152,1781,False,460,380,155,197,33,164,73,1462,9,6,1477,13,13,100.0,Boric
2021-12-05 05:24:46.923710,7152,1795,False,442,384,168,198,34,195,82,1503,11,6,1520,13,13,100.0,Boric
2021-12-05 05:24:46.923710,7152,1784,False,848,443,173,257,52,242,238,2253,20,6,2279,15,15,100.0,Boric
2021-12-05 05:24:46.923710,7152,1785,False,931,477,251,304,83,282,214,2542,18,6,2566,15,15,100.0,Boric
2021-12-05 05:24:46.923710,7152,1782,False,749,561,282,298,48,305,124,2367,25,12,2404,15,15,100.0,Boric
2021-12-05 05:24:46.923710,7152,1796,False,679,460,258,235,40,248,136,2056,19,4,2079,13,13,100.0,Boric
2021-12-05 05:24:46.923710,7152,1786,False,861,661,283,376,49,333,178,2741,18,3,2762,19,19,100.0,Boric
2021-12-05 05:24:46.923710,7152,1787,False,872,623,275,333,56,314,217,2690,26,7,2723,19,19,100.0,Boric
2021-12-05 05:24:46.923710,7152,1788,False,507,354,192,198,29,179,99,1558,20,11,1589,15,15,100.0,Boric
2021-12-05 05:24:46.923710,7152,1797,False,568,406,223,239,38,219,120,1813,15,7,1835,13,13,100.0,Boric
2021-12-05 05:24:46.923710,7152,1789,False,999,715,365,338,67,308,215,3007,12,9,3028,18,18,100.0,Boric
2021-12-05 05:24:46.923710,7152,1790,False,924,571,259,346,68,315,251,2734,13,5,2752,19,19,100.0,Boric
2021-12-05 05:24:46.923710,7152,1791,False,1045,610,296,341,72,303,275,2942,21,4,2967,19,19,100.0,Boric
2021-12-05 05:24:46.923710,7152,1792,False,909,467,253,237,63,226,163,2318,20,6,2344,15,15,100.0,Boric
2021-12-05 05:24:46.923710,7152,1798,False,810,382,190,237,63,190,145,2017,16,5,2038,13,13,100.0,Boric
2021-12-05 05:24:46.923710,7152,1793,False,1439,781,323,382,118,367,269,3679,40,2,3721,22,22,100.0,Boric
2021-12-05 05:24:46.923710,7152,1794,False,808,517,262,267,38,264,161,2317,12,10,2339,15,15,100.0,Boric
2021-12-05 05:24:46.923710,7152,1799,False,795,468,253,221,46,233,146,2162,20,6,2188,14,14,100.0,Boric
2021-12-05 05:24:46.923710,7110,447,False,449,421,149,145,31,146,336,1677,12,6,1695,10,10,100.0,Boric
2021-12-05 05:24:46.923710,7110,450,False,916,954,381,482,42,422,802,3999,25,17,4041,25,25,100.0,Kast
2021-12-05 05:24:46.923710,7110,448,False,702,671,232,235,44,294,506,2684,21,16,2721,15,15,100.0,Boric
2021-12-05 05:24:46.923710,7110,449,False,1019,951,403,375,69,419,644,3880,31,17,3928,24,24,100.0,Boric
2021-12-05 05:24:46.923710,7330,2793,False,333,654,690,372,20,124,256,2449,31,39,2519,17,17,100.0,Provoste
2021-12-05 05:24:46.923710,7330,2794,False,425,703,647,332,23,120,338,2588,47,46,2681,20,20,100.0,Kast
2021-12-05 05:24:46.923710,7631,1282,False,38,193,33,65,0,13,45,387,2,2,391,2,2,100.0,Kast
2021-12-05 05:24:46.923710,7556,1265,False,100,282,115,52,4,36,56,645,12,7,664,6,6,100.0,Kast
2021-12-05 05:24:46.923710,7539,1061,False,113,433,150,88,23,71,122,1000,17,23,1040,9,9,100.0,Kast
2021-12-05 05:24:46.923710,7543,1403,False,446,612,384,217,29,145,424,2257,18,8,2283,16,16,100.0,Kast
2021-12-05 05:24:46.923710,7543,1405,False,386,350,148,112,36,106,393,1531,11,4,1546,12,12,100.0,Parisi
2021-12-05 05:24:46.923710,7543,1404,False,752,951,473,264,48,177,702,3367,29,15,3411,25,25,100.0,Kast
2021-12-05 05:24:46.923710,7711,1464,False,1051,1212,617,410,82,279,947,4598,46,17,4661,30,30,100.0,Kast
2021-12-05 05:24:46.923710,7725,1090,False,51,85,37,37,5,18,37,270,4,14,288,3,3,100.0,Kast
2021-12-05 05:24:46.923710,7612,1428,False,41,75,32,27,1,5,30,211,3,2,216,2,2,100.0,Kast
2021-12-05 05:24:46.923710,7727,1092,False,57,198,71,33,4,41,127,531,9,12,552,4,4,100.0,Kast
2021-12-05 05:24:46.923710,7226,531,False,531,400,171,180,25,134,325,1766,16,5,1787,10,10,100.0,Boric
2021-12-05 05:24:46.923710,7226,532,False,766,478,107,234,44,144,595,2368,19,5,2392,14,14,100.0,Boric
2021-12-05 05:24:46.923710,7226,533,False,959,850,264,329,45,211,657,3315,19,8,3342,18,18,100.0,Boric
2021-12-05 05:24:46.923710,7226,534,False,625,318,93,165,31,114,437,1783,10,8,1801,12,12,100.0,Boric
2021-12-05 05:24:46.923710,7226,535,False,1452,1002,358,606,46,321,605,4390,25,8,4423,23,23,100.0,Boric
2021-12-05 05:24:46.923710,7226,536,False,587,435,209,195,26,158,422,2032,14,9,2055,13,13,100.0,Boric
2021-12-05 05:24:46.923710,7226,537,False,1042,993,372,559,47,398,633,4044,28,9,4081,25,25,100.0,Boric
2021-12-05 05:24:46.923710,7226,538,False,429,217,73,119,22,59,274,1193,8,2,1203,8,8,100.0,Boric
2021-12-05 05:24:46.923710,7226,539,False,1098,973,384,547,43,359,679,4083,42,6,4131,25,25,100.0,Boric
2021-12-05 05:24:46.923710,7226,540,False,958,861,273,345,44,214,509,3204,19,10,3233,16,16,100.0,Boric
2021-12-05 05:24:46.923710,7226,541,False,615,483,161,242,24,161,375,2061,17,2,2080,12,12,100.0,Boric
2021-12-05 05:24:46.923710,7226,542,False,983,1049,455,640,49,398,600,4174,29,18,4221,27,27,100.0,Kast
2021-12-05 05:24:46.923710,7226,543,False,662,702,253,350,31,258,389,2645,15,7,2667,16,16,100.0,Kast
2021-12-05 05:24:46.923710,7226,544,False,589,637,300,392,28,277,428,2651,24,11,2686,16,16,100.0,Kast
2021-12-05 05:24:46.923710,7226,545,False,384,438,214,222,24,154,252,1688,15,10,1713,10,10,100.0,Kast
2021-12-05 05:24:46.923710,7226,546,False,436,426,219,196,17,166,228,1688,15,3,1706,10,10,100.0,Boric
2021-12-05 05:24:46.923710,7226,547,False,668,699,350,358,31,296,411,2813,36,14,2863,17,17,100.0,Kast
2021-12-05 05:24:46.923710,7226,548,False,1017,1097,391,567,33,361,622,4088,39,12,4139,25,25,100.0,Kast
2021-12-05 05:24:46.923710,7226,549,False,973,1110,494,622,42,357,447,4045,27,11,4083,27,27,100.0,Kast
2021-12-05 05:24:46.923710,7226,550,False,1164,1108,518,526,51,338,638,4343,45,17,4405,25,25,100.0,Boric
2021-12-05 05:24:46.923710,7226,554,False,1221,1094,444,506,58,348,689,4360,43,15,4418,25,25,100.0,Boric
2021-12-05 05:24:46.923710,7226,551,False,1157,1084,540,532,56,404,644,4417,42,28,4487,26,26,100.0,Boric
2021-12-05 05:24:46.923710,7226,552,False,547,642,305,310,24,199,272,2299,28,6,2333,17,17,100.0,Kast
2021-12-05 05:24:46.923710,7226,553,False,1205,1038,440,627,53,409,769,4541,35,10,4586,25,25,100.0,Boric
2021-12-05 05:24:46.923710,7535,661,False,594,650,187,290,22,287,676,2706,19,3,2728,20,20,100.0,Parisi
2021-12-05 05:24:46.923710,7535,662,False,910,994,391,457,38,312,531,3633,40,10,3683,21,21,100.0,Kast
2021-12-05 05:24:46.923710,7535,663,False,660,508,127,285,27,202,836,2645,21,6,2672,20,20,100.0,Parisi
2021-12-05 05:24:46.923710,7535,667,False,1043,939,402,575,42,335,440,3776,29,9,3814,22,22,100.0,Boric
2021-12-05 05:24:46.923710,7535,664,False,835,577,197,306,44,216,824,2999,27,5,3031,20,20,100.0,Boric
2021-12-05 05:24:46.923710,7535,665,False,1013,584,206,367,49,205,580,3004,19,16,3039,18,18,100.0,Boric
2021-12-05 05:24:46.923710,7535,666,False,499,301,114,207,25,106,288,1540,15,4,1559,11,11,100.0,Boric
2021-12-05 05:24:46.923710,7730,2809,False,77,163,121,32,4,35,71,503,4,4,511,3,3,100.0,Kast
2021-12-05 05:24:46.923710,7325,2785,False,356,991,507,321,19,144,381,2719,23,22,2764,20,20,100.0,Kast
2021-12-05 05:24:46.923710,7059,229,False,133,238,181,90,8,66,190,906,4,8,918,8,8,100.0,Kast
2021-12-05 05:24:46.923710,7275,715,False,304,729,358,249,17,173,243,2073,26,19,2118,14,14,100.0,Kast
2021-12-05 05:24:46.923710,7275,714,False,298,745,364,318,20,210,283,2238,21,10,2269,15,15,100.0,Kast
2021-12-05 05:24:46.923710,7317,2769,False,151,501,102,200,4,58,73,1089,9,10,1108,9,9,100.0,Kast
2021-12-05 05:24:46.923710,7136,1659,False,915,599,321,361,67,354,281,2898,22,14,2934,20,20,100.0,Boric
2021-12-05 05:24:46.923710,7136,1661,False,1151,665,297,257,96,309,259,3034,28,11,3073,19,19,100.0,Boric
2021-12-05 05:24:46.923710,7136,1660,False,1226,615,343,422,100,431,281,3418,24,9,3451,20,20,100.0,Boric
2021-12-05 05:24:46.923710,7136,1663,False,1063,642,387,383,80,355,225,3135,29,20,3184,20,20,100.0,Boric
2021-12-05 05:24:46.923710,7136,1664,False,945,474,304,251,62,283,202,2521,17,6,2544,16,16,100.0,Boric
2021-12-05 05:24:46.923710,7136,1665,False,986,636,401,359,69,399,263,3113,34,12,3159,20,20,100.0,Boric
2021-12-05 05:24:46.923710,7136,1662,False,1029,506,321,219,63,252,228,2618,13,24,2655,19,19,100.0,Boric
2021-12-05 05:24:46.923710,7136,1667,False,817,632,299,374,66,335,216,2739,20,13,2772,20,20,100.0,Boric
2021-12-05 05:24:46.923710,7136,1666,False,693,426,203,257,45,238,221,2083,15,7,2105,14,14,100.0,Boric
2021-12-05 05:24:46.923710,7136,1668,False,744,382,196,251,51,240,193,2057,13,9,2079,14,14,100.0,Boric
2021-12-05 05:24:46.923710,7138,1669,False,597,306,112,135,49,143,152,1494,11,3,1508,17,17,100.0,Boric
2021-12-05 05:24:46.923710,7138,1670,False,703,288,133,165,49,120,109,1567,15,3,1585,17,17,100.0,Boric
2021-12-05 05:24:46.923710,7138,1671,False,603,383,186,265,61,162,103,1763,18,8,1789,15,15,100.0,Boric
2021-12-05 05:24:46.923710,7138,1674,False,740,537,246,296,42,245,130,2236,21,5,2262,17,17,100.0,Boric
2021-12-05 05:24:46.923710,7138,1675,False,663,523,204,297,33,221,138,2079,16,4,2099,17,17,100.0,Boric
2021-12-05 05:24:46.923710,7138,1683,False,389,304,110,161,20,141,105,1230,10,8,1248,10,10,100.0,Boric
2021-12-05 05:24:46.923710,7138,1682,False,717,445,182,254,42,167,120,1927,14,6,1947,15,15,100.0,Boric
2021-12-05 05:24:46.923710,7138,1685,False,612,391,155,177,37,196,151,1719,9,5,1733,13,13,100.0,Boric
2021-12-05 05:24:46.923710,7138,1673,False,1409,794,316,464,95,344,234,3656,27,7,3690,24,24,100.0,Boric
2021-12-05 05:24:46.923710,7138,1676,False,540,226,93,134,29,100,84,1206,11,5,1222,16,16,100.0,Boric
2021-12-05 05:24:46.923710,7138,1680,False,656,435,243,223,42,130,98,1827,18,11,1856,16,16,100.0,Boric
2021-12-05 05:24:46.923710,7138,1681,False,645,447,255,244,42,177,104,1914,17,8,1939,16,16,100.0,Boric
2021-12-05 05:24:46.923710,7138,1684,False,688,527,301,294,31,238,94,2173,19,9,2201,16,16,100.0,Boric
2021-12-05 05:24:46.923710,7138,1678,False,1214,631,236,271,111,242,274,2979,21,8,3008,21,21,100.0,Boric
2021-12-05 05:24:46.923710,7138,1672,False,711,563,271,267,54,230,146,2242,13,6,2261,18,18,100.0,Boric
2021-12-05 05:24:46.923710,7138,1677,False,375,160,52,70,35,67,86,845,10,4,859,12,12,100.0,Boric
2021-12-05 05:24:46.923710,7138,1679,False,1028,674,328,365,76,258,137,2866,20,9,2895,24,24,100.0,Boric
2021-12-05 05:24:46.923710,7383,1111,False,176,708,292,183,13,126,360,1858,27,8,1893,15,15,100.0,Kast
2021-12-05 05:24:46.923710,7383,1112,False,185,618,197,119,17,83,289,1508,22,15,1545,14,14,100.0,Kast
2021-12-05 05:24:46.923710,7150,1761,False,1110,538,395,339,74,485,322,3263,20,6,3289,18,18,100.0,Boric
2021-12-05 05:24:46.923710,7150,1762,False,505,226,106,107,35,189,220,1388,7,8,1403,10,10,100.0,Boric
2021-12-05 05:24:46.923710,7150,1763,False,734,369,247,174,58,277,279,2138,19,6,2163,13,13,100.0,Boric
2021-12-05 05:24:46.923710,7150,1779,False,794,434,228,167,79,244,280,2226,13,10,2249,13,13,100.0,Boric
2021-12-05 05:24:46.923710,7150,1764,False,935,558,382,322,75,522,412,3206,20,10,3236,20,20,100.0,Boric
2021-12-05 05:24:46.923710,7150,1765,False,669,424,340,220,44,339,200,2236,26,14,2276,18,18,100.0,Boric
2021-12-05 05:24:46.923710,7150,1766,False,1002,639,433,387,79,523,377,3440,186,12,3638,24,24,100.0,Boric
2021-12-05 05:24:46.923710,7150,1772,False,803,519,423,283,56,376,265,2725,22,8,2755,18,18,100.0,Boric
2021-12-05 05:24:46.923710,7150,1767,False,949,366,128,167,106,330,603,2649,14,4,2667,19,19,100.0,Boric
2021-12-05 05:24:46.923710,7150,1768,False,638,371,299,217,45,320,197,2087,22,12,2121,14,14,100.0,Boric
2021-12-05 05:24:46.923710,7150,1780,False,657,408,321,216,39,289,216,2146,18,4,2168,14,14,100.0,Boric
2021-12-05 05:24:46.923710,7150,1769,False,940,624,423,364,60,481,342,3234,35,11,3280,24,24,100.0,Boric
2021-12-05 05:24:46.923710,7150,1770,False,685,429,240,240,51,359,250,2254,18,8,2280,16,16,100.0,Boric
2021-12-05 05:24:46.923710,7150,1771,False,652,374,258,223,57,352,297,2213,16,6,2235,16,16,100.0,Boric
2021-12-05 05:24:46.923710,7150,1773,False,854,586,420,388,73,520,312,3153,45,10,3208,24,24,100.0,Boric
2021-12-05 05:24:46.923710,7150,1777,False,870,278,183,157,83,262,440,2273,16,8,2297,17,17,100.0,Boric
2021-12-05 05:24:46.923710,7150,1778,False,863,252,120,129,74,238,371,2047,15,11,2073,16,16,100.0,Boric
2021-12-05 05:24:46.923710,7150,1775,False,824,522,322,229,64,388,277,2626,18,8,2652,17,17,100.0,Boric
2021-12-05 05:24:46.923710,7150,1776,False,839,504,323,233,76,373,346,2694,19,12,2725,17,17,100.0,Boric
2021-12-05 05:24:46.923710,7150,1774,False,738,506,393,298,52,430,231,2648,22,17,2687,18,18,100.0,Boric
2021-12-05 05:24:46.923710,7234,576,False,325,213,71,104,16,80,192,1001,7,7,1015,7,7,100.0,Boric
2021-12-05 05:24:46.923710,7234,584,False,631,624,455,297,29,242,381,2659,30,23,2712,17,17,100.0,Boric
2021-12-05 05:24:46.923710,7234,577,False,521,545,412,286,21,244,269,2298,34,12,2344,16,16,100.0,Kast
2021-12-05 05:24:46.923710,7234,578,False,566,660,397,350,27,271,356,2627,26,18,2671,17,17,100.0,Kast
2021-12-05 05:24:46.923710,7234,579,False,334,285,82,78,26,79,421,1305,3,2,1310,10,10,100.0,Parisi
2021-12-05 05:24:46.923710,7234,580,False,460,333,148,136,31,135,241,1484,13,4,1501,10,10,100.0,Boric
2021-12-05 05:24:46.923710,7234,581,False,802,870,457,428,36,352,454,3399,37,19,3455,19,19,100.0,Kast
2021-12-05 05:24:46.923710,7234,582,False,581,570,498,279,26,255,276,2485,35,27,2547,17,17,100.0,Boric
2021-12-05 05:24:46.923710,7234,583,False,847,823,419,317,52,283,531,3272,36,32,3340,19,19,100.0,Boric
2021-12-05 05:24:46.923710,7748,527,False,521,2866,275,1060,12,91,73,4898,19,11,4928,20,20,100.0,Kast
2021-12-05 05:24:46.923710,7748,528,False,800,2702,293,1218,25,92,99,5229,21,8,5258,20,20,100.0,Kast
2021-12-05 05:24:46.923710,7233,572,False,288,531,269,233,20,180,330,1851,14,8,1873,12,12,100.0,Kast
2021-12-05 05:24:46.923710,7233,573,False,357,496,111,204,15,79,338,1600,11,3,1614,10,10,100.0,Kast
2021-12-05 05:24:46.923710,7233,575,False,334,623,245,244,15,181,400,2042,16,12,2070,12,12,100.0,Kast
2021-12-05 05:24:46.923710,7233,574,False,842,1277,621,494,42,350,752,4378,44,192,4614,26,26,100.0,Kast
2021-12-05 05:24:46.923710,7371,1032,False,51,97,78,46,2,25,45,344,2,5,351,3,3,100.0,Kast
2021-12-05 05:24:46.923710,7297,792,False,193,782,258,358,13,99,162,1865,16,20,1901,14,14,100.0,Kast
2021-12-05 05:24:46.923710,7297,793,False,278,822,251,335,20,135,243,2084,16,20,2120,14,14,100.0,Kast
2021-12-05 05:24:46.923710,7297,794,False,437,1358,424,533,22,166,332,3272,39,49,3360,24,24,100.0,Kast
2021-12-05 05:24:46.923710,7654,2658,False,83,285,56,50,11,34,90,609,2,5,616,5,5,100.0,Kast
2021-12-05 05:24:46.923710,7561,1410,False,95,274,169,107,7,28,103,783,4,4,791,6,6,100.0,Kast
2021-12-05 05:24:46.923710,7571,1416,False,97,107,67,57,6,39,63,436,2,1,439,4,4,100.0,Kast
2021-12-05 05:24:46.923710,7082,287,False,394,503,306,229,17,174,328,1951,6,10,1967,11,11,100.0,Kast
2021-12-05 05:24:46.923710,7082,289,False,229,251,204,130,19,92,156,1081,8,7,1096,6,6,100.0,Kast
2021-12-05 05:24:46.923710,7082,288,False,474,661,200,285,27,109,379,2135,10,10,2155,11,11,100.0,Kast
2021-12-05 05:24:46.923710,7680,2663,False,68,180,56,28,2,23,27,384,6,2,392,3,3,100.0,Kast
2021-12-05 05:24:46.923710,7542,2651,False,124,532,136,129,13,43,78,1055,15,28,1098,8,8,100.0,Kast
2021-12-05 05:24:46.923710,7439,2641,False,318,777,340,200,23,76,230,1964,22,20,2006,17,17,100.0,Kast
2021-12-05 05:24:46.923710,7439,2642,False,474,979,275,233,28,84,383,2456,16,172,2644,18,18,100.0,Kast
2021-12-05 05:24:46.923710,7439,2643,False,362,924,328,252,15,108,296,2285,27,12,2324,16,16,100.0,Kast
2021-12-05 05:24:46.923710,7439,2644,False,259,824,318,224,21,91,214,1951,19,20,1990,17,17,100.0,Kast
2021-12-05 05:24:46.923710,7439,2645,False,425,885,316,218,36,103,292,2275,25,24,2324,17,17,100.0,Kast
2021-12-05 05:24:46.923710,7372,1033,False,80,219,105,53,3,35,69,564,2,7,573,6,6,100.0,Kast
2021-12-05 05:24:46.923710,7280,741,False,461,953,451,473,33,242,410,3023,50,33,3106,20,20,100.0,Kast
2021-12-05 05:24:46.923710,7280,742,False,395,735,376,347,27,191,316,2387,41,45,2473,16,16,100.0,Kast
2021-12-05 05:24:46.923710,7747,526,False,90,56,73,43,7,25,109,403,4,6,413,2,2,100.0,Parisi
2021-12-05 05:24:46.923710,7056,224,False,241,219,304,145,11,83,247,1250,12,6,1268,12,12,100.0,Provoste
2021-12-05 05:24:46.923710,7499,1498,False,120,204,122,59,4,21,59,589,15,15,619,5,5,100.0,Kast
2021-12-05 05:24:46.923710,7449,1335,False,302,732,402,215,18,106,300,2075,18,11,2104,14,14,100.0,Kast
2021-12-05 05:24:46.923710,7449,1336,False,278,594,404,211,15,86,225,1813,29,21,1863,14,14,100.0,Kast
2021-12-05 05:24:46.923710,7449,1337,False,216,558,339,170,10,70,199,1562,15,8,1585,12,12,100.0,Kast
2021-12-05 05:24:46.923710,7549,1502,False,77,63,39,24,2,21,18,244,2,4,250,2,2,100.0,Boric
2021-12-05 05:24:46.923710,7507,1549,False,52,101,17,26,0,29,31,256,2,0,258,3,3,100.0,Kast
2021-12-05 05:24:46.923710,7484,1400,False,44,151,47,82,5,26,49,404,5,8,417,4,4,100.0,Kast
2021-12-05 05:24:46.923710,7266,698,False,596,1134,557,419,37,226,434,3403,22,34,3459,22,22,100.0,Kast
2021-12-05 05:24:46.923710,7266,699,False,453,1011,488,477,25,236,308,2998,30,15,3043,19,19,100.0,Kast
2021-12-05 05:24:46.923710,7554,669,False,400,455,266,190,27,184,262,1784,23,15,1822,14,14,100.0,Kast
2021-12-05 05:24:46.923710,7593,2801,False,92,162,88,68,6,29,64,509,4,4,517,4,4,100.0,Kast
2021-12-05 05:24:46.923710,7418,1245,False,322,595,507,184,37,167,204,2016,35,24,2075,16,16,100.0,Kast
2021-12-05 05:24:46.923710,7418,1246,False,337,590,445,152,47,165,237,1973,52,30,2055,17,17,100.0,Kast
2021-12-05 05:24:46.923710,7269,706,False,545,844,591,413,31,260,409,3093,18,18,3129,21,21,100.0,Kast
2021-12-05 05:24:46.923710,7269,707,False,545,707,639,314,30,224,428,2887,31,30,2948,19,19,100.0,Kast
2021-12-05 05:24:46.923710,7065,243,False,821,659,379,247,61,163,1143,3473,32,12,3517,25,25,100.0,Parisi
2021-12-05 05:24:46.923710,7065,242,False,555,592,502,294,36,194,612,2785,26,18,2829,20,20,100.0,Parisi
2021-12-05 05:24:46.923710,7065,241,False,538,498,512,187,32,146,510,2423,16,21,2460,17,17,100.0,Boric
2021-12-05 05:24:46.923710,7752,1100,False,108,263,71,91,7,53,90,683,5,3,691,5,5,100.0,Kast
2021-12-05 05:24:46.923710,7117,484,False,1044,688,386,280,103,378,589,3468,23,8,3499,20,20,100.0,Boric
2021-12-05 05:24:46.923710,7117,485,False,832,434,416,202,68,303,355,2610,29,12,2651,15,15,100.0,Boric
2021-12-05 05:24:46.923710,7117,486,False,883,346,169,130,107,222,563,2420,16,2,2438,15,15,100.0,Boric
2021-12-05 05:24:46.923710,7117,487,False,1399,867,831,430,94,537,579,4737,46,30,4813,30,30,100.0,Boric
2021-12-05 05:24:46.923710,7117,488,False,519,215,88,119,50,113,229,1333,11,5,1349,9,9,100.0,Boric
2021-12-05 05:24:46.923710,7117,489,False,1130,739,556,406,74,513,511,3929,31,8,3968,23,23,100.0,Boric
2021-12-05 05:24:46.923710,7117,490,False,1666,893,736,369,160,533,780,5137,66,22,5225,30,30,100.0,Boric
2021-12-05 05:24:46.923710,7117,491,False,1240,915,667,497,92,539,566,4516,37,16,4569,30,30,100.0,Boric
2021-12-05 05:24:46.923710,7117,492,False,475,303,230,154,32,210,237,1641,13,12,1666,10,10,100.0,Boric
2021-12-05 05:24:46.923710,7117,493,False,1109,629,438,358,95,441,627,3697,22,8,3727,20,20,100.0,Boric
2021-12-05 05:24:46.923710,7117,495,False,1037,519,345,325,116,350,465,3157,15,8,3180,17,17,100.0,Boric
2021-12-05 05:24:46.923710,7117,494,False,531,297,145,122,46,154,371,1666,10,4,1680,10,10,100.0,Boric
2021-12-05 05:24:46.923710,7211,2348,False,896,683,309,263,41,272,302,2766,13,6,2785,17,17,100.0,Boric
2021-12-05 05:24:46.923710,7211,2349,False,999,784,289,245,65,278,305,2965,14,11,2990,17,17,100.0,Boric
2021-12-05 05:24:46.923710,7211,2387,False,733,451,124,177,50,188,260,1983,17,6,2006,15,15,100.0,Boric
2021-12-05 05:24:46.923710,7211,2350,False,400,203,62,79,21,115,227,1107,5,6,1118,9,9,100.0,Boric
2021-12-05 05:24:46.923710,7211,2386,False,588,419,152,186,36,205,225,1811,12,9,1832,15,15,100.0,Boric
2021-12-05 05:24:46.923710,7211,2351,False,1056,446,132,227,76,321,504,2762,35,9,2806,20,20,100.0,Boric
2021-12-05 05:24:46.923710,7211,2385,False,803,253,84,140,49,188,283,1800,14,3,1817,15,15,100.0,Boric
2021-12-05 05:24:46.923710,7211,2352,False,677,422,132,174,40,241,427,2113,13,1,2127,16,16,100.0,Boric
2021-12-05 05:24:46.923710,7211,2353,False,729,381,122,153,46,223,418,2072,13,2,2087,16,16,100.0,Boric
2021-12-05 05:24:46.923710,7211,2354,False,751,634,347,275,33,315,261,2616,24,12,2652,19,19,100.0,Boric
2021-12-05 05:24:46.923710,7211,2355,False,722,611,283,295,29,316,223,2479,24,6,2509,16,16,100.0,Boric
2021-12-05 05:24:46.923710,7211,2356,False,704,705,282,262,48,303,273,2577,26,7,2610,17,17,100.0,Kast
2021-12-05 05:24:46.923710,7211,2357,False,725,699,254,247,40,290,288,2543,24,6,2573,17,17,100.0,Boric
2021-12-05 05:24:46.923710,7211,2358,False,818,743,323,325,52,383,288,2932,24,6,2962,19,19,100.0,Boric
2021-12-05 05:24:46.923710,7211,2368,False,637,577,326,250,30,302,194,2316,41,16,2373,17,17,100.0,Boric
2021-12-05 05:24:46.923710,7211,2361,False,1015,725,336,395,57,361,258,3147,17,6,3170,17,17,100.0,Boric
2021-12-05 05:24:46.923710,7211,2362,False,770,540,258,256,39,244,197,2304,14,6,2324,16,16,100.0,Boric
2021-12-05 05:24:46.923710,7211,2363,False,619,339,83,147,30,205,358,1781,7,4,1792,14,14,100.0,Boric
2021-12-05 05:24:46.923710,7211,2364,False,579,640,353,220,32,268,156,2248,18,16,2282,18,18,100.0,Kast
2021-12-05 05:24:46.923710,7211,2365,False,647,332,131,188,47,197,283,1825,10,1,1836,14,14,100.0,Boric
2021-12-05 05:24:46.923710,7211,2366,False,807,695,383,315,44,356,233,2833,26,17,2876,18,18,100.0,Boric
2021-12-05 05:24:46.923710,7211,2367,False,661,654,266,277,43,346,241,2488,17,10,2515,17,17,100.0,Boric
2021-12-05 05:24:46.923710,7211,2359,False,830,778,326,302,50,342,303,2931,21,13,2965,20,20,100.0,Boric
2021-12-05 05:24:46.923710,7211,2369,False,833,845,363,380,37,374,292,3124,32,11,3167,21,21,100.0,Kast
2021-12-05 05:24:46.923710,7211,2370,False,824,768,316,351,47,387,289,2982,18,12,3012,20,20,100.0,Boric
2021-12-05 05:24:46.923710,7211,2371,False,962,731,328,325,42,347,222,2957,20,5,2982,17,17,100.0,Boric
2021-12-05 05:24:46.923710,7211,2360,False,673,537,320,226,32,271,190,2249,21,14,2284,15,15,100.0,Boric
2021-12-05 05:24:46.923710,7211,2384,False,733,321,107,139,44,176,307,1827,11,8,1846,15,15,100.0,Boric
2021-12-05 05:24:46.923710,7211,2375,False,470,535,180,223,22,187,118,1735,15,8,1758,13,13,100.0,Kast
2021-12-05 05:24:46.923710,7211,2376,False,465,501,215,217,21,211,119,1749,16,8,1773,13,13,100.0,Kast
2021-12-05 05:24:46.923710,7211,2377,False,747,725,322,343,30,313,194,2674,26,10,2710,18,18,100.0,Boric
2021-12-05 05:24:46.923710,7211,2378,False,753,728,311,361,40,309,237,2739,16,11,2766,18,18,100.0,Boric
2021-12-05 05:24:46.923710,7211,2379,False,672,600,343,277,28,280,177,2377,31,13,2421,16,16,100.0,Boric
2021-12-05 05:24:46.923710,7211,2380,False,699,568,322,268,28,302,186,2373,21,11,2405,16,16,100.0,Boric
2021-12-05 05:24:46.923710,7211,2374,False,645,495,133,177,38,248,478,2214,21,3,2238,19,19,100.0,Boric
2021-12-05 05:24:46.923710,7211,2381,False,721,375,112,181,46,266,426,2127,4,2,2133,16,16,100.0,Boric
2021-12-05 05:24:46.923710,7211,2372,False,617,653,280,301,31,253,170,2305,21,13,2339,17,17,100.0,Kast
2021-12-05 05:24:46.923710,7211,2373,False,633,638,266,302,32,304,173,2348,20,3,2371,17,17,100.0,Kast
2021-12-05 05:24:46.923710,7211,2382,False,777,675,364,256,64,310,218,2664,35,9,2708,18,18,100.0,Boric
2021-12-05 05:24:46.923710,7211,2383,False,918,349,85,206,75,240,437,2310,17,6,2333,17,17,100.0,Boric
2021-12-05 05:24:46.923710,7310,2752,False,446,1272,431,404,29,155,394,3131,29,21,3181,21,21,100.0,Kast
2021-12-05 05:24:46.923710,7310,2753,False,309,702,203,258,12,85,203,1772,11,11,1794,10,10,100.0,Kast
2021-12-05 05:24:46.923710,7310,2754,False,374,801,304,252,15,91,275,2112,20,15,2147,15,15,100.0,Kast
2021-12-05 05:24:46.923710,7310,2755,False,374,882,249,238,23,87,288,2141,22,12,2175,15,15,100.0,Kast
2021-12-05 05:24:46.923710,7310,2756,False,519,867,230,210,25,91,373,2315,13,15,2343,16,16,100.0,Kast
2021-12-05 05:24:46.923710,7310,2757,False,187,547,190,150,7,75,130,1286,13,12,1311,11,11,100.0,Kast
2021-12-05 05:24:46.923710,7310,2758,False,539,1653,518,516,25,202,349,3802,32,28,3862,30,30,100.0,Kast
2021-12-05 05:24:46.923710,7310,2759,False,250,808,274,238,15,97,216,1898,16,25,1939,15,15,100.0,Kast
2021-12-05 05:24:46.923710,7702,1087,False,41,142,52,34,6,35,68,378,11,12,401,4,4,100.0,Kast
2021-12-05 05:24:46.923710,7281,743,False,294,475,259,187,21,117,199,1552,14,7,1573,10,10,100.0,Kast
2021-12-05 05:24:46.923710,7281,744,False,299,483,304,240,14,130,222,1692,18,12,1722,12,12,100.0,Kast
2021-12-05 05:24:46.923710,7281,745,False,584,837,340,283,23,179,653,2899,21,11,2931,22,22,100.0,Kast
2021-12-05 05:24:46.923710,7281,746,False,436,703,564,264,19,212,309,2507,46,21,2574,20,20,100.0,Kast
2021-12-05 05:24:46.923710,7281,747,False,421,719,476,337,19,213,355,2540,29,28,2597,20,20,100.0,Kast
2021-12-05 05:24:46.923710,7281,748,False,518,766,479,316,28,183,446,2736,41,34,2811,20,20,100.0,Kast
2021-12-05 05:24:46.923710,7080,281,False,344,305,123,140,15,69,402,1398,14,5,1417,8,8,100.0,Parisi
2021-12-05 05:24:46.923710,7080,282,False,593,690,485,452,33,253,599,3105,36,13,3154,17,17,100.0,Kast
2021-12-05 05:24:46.923710,7080,283,False,699,765,559,371,38,247,683,3362,36,19,3417,18,18,100.0,Kast
2021-12-05 05:24:46.923710,7313,2762,False,394,805,392,308,14,97,281,2291,25,22,2338,17,17,100.0,Kast
2021-12-05 05:24:46.923710,7083,290,False,798,878,400,387,47,302,529,3341,23,9,3373,20,20,100.0,Kast
2021-12-05 05:24:46.923710,7083,291,False,845,593,201,283,55,148,519,2644,16,12,2672,17,17,100.0,Boric
2021-12-05 05:24:46.923710,7083,292,False,578,321,115,165,32,108,504,1823,15,7,1845,12,12,100.0,Boric
2021-12-05 05:24:46.923710,7083,293,False,1231,1262,489,609,67,350,798,4806,28,13,4847,25,25,100.0,Kast
2021-12-05 05:24:46.923710,7083,294,False,493,317,92,139,29,87,577,1734,11,2,1747,12,12,100.0,Parisi
2021-12-05 05:24:46.923710,7083,295,False,887,921,305,330,50,204,522,3219,16,11,3246,17,17,100.0,Kast
2021-12-05 05:24:46.923710,7083,296,False,841,1174,480,511,48,358,507,3919,54,25,3998,25,25,100.0,Kast
2021-12-05 05:24:46.923710,7083,297,False,1036,1066,574,386,48,329,636,4075,31,24,4130,25,25,100.0,Kast
2021-12-05 05:24:46.923710,7083,298,False,982,1010,624,443,49,314,521,3943,45,29,4017,25,25,100.0,Kast
2021-12-05 05:24:46.923710,7616,167,False,37,63,126,18,3,9,80,336,4,2,342,3,3,100.0,Provoste
2021-12-05 05:24:46.923710,7246,610,False,597,717,210,272,29,125,310,2260,7,4,2271,12,12,100.0,Kast
2021-12-05 05:24:46.923710,7246,620,False,697,549,174,255,41,113,309,2138,16,5,2159,14,14,100.0,Boric
2021-12-05 05:24:46.923710,7246,611,False,814,964,444,500,48,219,389,3378,22,15,3415,20,20,100.0,Kast
2021-12-05 05:24:46.923710,7246,612,False,830,937,356,374,44,215,460,3216,21,12,3249,19,19,100.0,Kast
2021-12-05 05:24:46.923710,7246,613,False,715,843,480,392,47,235,440,3152,36,25,3213,19,19,100.0,Kast
2021-12-05 05:24:46.923710,7246,614,False,677,788,347,434,29,240,384,2899,17,13,2929,18,18,100.0,Kast
2021-12-05 05:24:46.923710,7246,615,False,316,198,38,97,14,52,265,980,8,4,992,7,7,100.0,Boric
2021-12-05 05:24:46.923710,7246,616,False,531,791,407,469,29,209,264,2700,28,14,2742,18,18,100.0,Kast
2021-12-05 05:24:46.923710,7246,617,False,636,862,548,445,32,241,334,3098,44,24,3166,19,19,100.0,Kast
2021-12-05 05:24:46.923710,7246,618,False,577,752,406,490,29,230,357,2841,21,14,2876,18,18,100.0,Kast
2021-12-05 05:24:46.923710,7246,619,False,484,537,258,318,20,168,322,2107,24,12,2143,12,12,100.0,Kast
2021-12-05 05:24:46.923710,7509,1551,False,52,95,5,32,0,27,33,244,2,3,249,2,2,100.0,Kast
2021-12-05 05:24:46.923710,7318,2770,False,239,828,315,339,21,139,219,2100,18,16,2134,19,19,100.0,Kast
2021-12-05 05:24:46.923710,7318,2771,False,252,887,295,290,23,130,215,2092,24,17,2133,21,21,100.0,Kast
2021-12-05 05:24:46.923710,7299,797,False,702,1220,468,441,35,217,568,3651,17,13,3681,23,23,100.0,Kast
2021-12-05 05:24:46.923710,7299,798,False,506,993,444,442,26,171,417,2999,20,13,3032,21,21,100.0,Kast
2021-12-05 05:24:46.923710,7299,799,False,422,857,499,331,21,186,319,2635,23,34,2692,21,21,100.0,Kast
2021-12-05 05:24:46.923710,7299,800,False,384,847,455,405,16,188,295,2590,29,17,2636,21,21,100.0,Kast
2021-12-05 05:24:46.923710,7299,801,False,581,926,425,346,28,144,433,2883,17,27,2927,21,21,100.0,Kast
2021-12-05 05:24:46.923710,7183,2040,False,1119,561,427,344,59,300,232,3042,24,10,3076,20,20,100.0,Boric
2021-12-05 05:24:46.923710,7183,2041,False,984,567,325,359,56,354,216,2861,19,7,2887,21,21,100.0,Boric
2021-12-05 05:24:46.923710,7183,2043,False,1159,517,290,338,67,332,222,2925,25,12,2962,20,20,100.0,Boric
2021-12-05 05:24:46.923710,7183,2039,False,973,516,314,345,53,305,217,2723,13,9,2745,19,19,100.0,Boric
2021-12-05 05:24:46.923710,7183,2044,False,1153,419,271,254,78,269,205,2649,23,16,2688,17,17,100.0,Boric
2021-12-05 05:24:46.923710,7183,2053,False,696,325,181,229,47,188,150,1816,11,3,1830,13,13,100.0,Boric
2021-12-05 05:24:46.923710,7183,2042,False,1144,521,401,352,88,341,258,3105,26,14,3145,19,19,100.0,Boric
2021-12-05 05:24:46.923710,7183,2045,False,1314,574,335,367,91,357,383,3421,28,9,3458,22,22,100.0,Boric
2021-12-05 05:24:46.923710,7183,2046,False,710,299,181,159,51,196,157,1753,13,6,1772,11,11,100.0,Boric
2021-12-05 05:24:46.923710,7183,2047,False,1043,455,286,246,57,268,190,2545,25,13,2583,18,18,100.0,Boric
2021-12-05 05:24:46.923710,7183,2048,False,907,420,282,267,64,243,173,2356,26,6,2388,18,18,100.0,Boric
2021-12-05 05:24:46.923710,7183,2049,False,862,395,202,158,70,183,125,1995,14,7,2016,12,12,100.0,Boric
2021-12-05 05:24:46.923710,7183,2050,False,853,494,324,291,63,305,187,2517,20,11,2548,16,16,100.0,Boric
2021-12-05 05:24:46.923710,7183,2051,False,780,429,275,285,55,259,137,2220,30,12,2262,19,19,100.0,Boric
2021-12-05 05:24:46.923710,7183,2052,False,1290,479,307,373,54,346,190,3039,24,8,3071,18,18,100.0,Boric
2021-12-05 05:24:46.923710,7749,1095,False,34,137,70,18,7,41,62,369,4,1,374,3,3,100.0,Kast
2021-12-05 05:24:46.923710,7187,2089,False,1277,921,439,678,72,417,283,4087,33,9,4129,24,24,100.0,Boric
2021-12-05 05:24:46.923710,7187,2099,False,978,607,316,452,56,330,203,2942,17,12,2971,20,20,100.0,Boric
2021-12-05 05:24:46.923710,7187,2100,False,1058,616,319,469,69,325,262,3118,22,9,3149,20,20,100.0,Boric
2021-12-05 05:24:46.923710,7187,2090,False,959,458,219,302,75,250,267,2530,19,2,2551,16,16,100.0,Boric
2021-12-05 05:24:46.923710,7187,2091,False,1181,446,153,290,73,289,444,2876,15,2,2893,18,18,100.0,Boric
2021-12-05 05:24:46.923710,7187,2092,False,1783,940,494,715,91,505,357,4885,42,9,4936,24,24,100.0,Boric
2021-12-05 05:24:46.923710,7187,2093,False,1233,388,166,312,82,233,352,2766,25,4,2795,17,17,100.0,Boric
2021-12-05 05:24:46.923710,7187,2095,False,754,594,364,358,54,239,154,2517,27,8,2552,16,16,100.0,Boric
2021-12-05 05:24:46.923710,7187,2096,False,842,582,368,385,47,260,147,2631,19,8,2658,15,15,100.0,Boric
2021-12-05 05:24:46.923710,7187,2094,False,1117,601,305,300,60,233,220,2836,17,5,2858,14,14,100.0,Boric
2021-12-05 05:24:46.923710,7187,2097,False,1292,879,529,547,70,397,261,3975,28,13,4016,24,24,100.0,Boric
2021-12-05 05:24:46.923710,7187,2098,False,1468,892,524,577,84,415,299,4259,21,9,4289,24,24,100.0,Boric
2021-12-05 05:24:46.923710,7187,2101,False,1117,881,467,647,69,438,254,3873,29,15,3917,24,24,100.0,Boric
2021-12-05 05:24:46.923710,7210,2347,False,325,131,56,71,12,43,45,683,8,0,691,4,4,100.0,Boric
2021-12-05 05:24:46.923710,7210,2345,False,1178,676,449,453,74,357,253,3440,39,11,3490,21,21,100.0,Boric
2021-12-05 05:24:46.923710,7210,2346,False,1375,810,517,416,77,371,271,3837,51,23,3911,23,23,100.0,Boric
2021-12-05 05:24:46.923710,7450,1338,False,351,483,588,179,30,124,293,2048,30,13,2091,18,18,100.0,Provoste
2021-12-05 05:24:46.923710,7712,44,False,46,159,48,25,3,26,151,458,5,3,466,4,4,100.0,Kast
2021-12-05 05:24:46.923710,7195,2168,False,827,733,409,551,42,395,180,3137,30,15,3182,19,19,100.0,Boric
2021-12-05 05:24:46.923710,7195,2169,False,988,700,372,555,45,399,244,3303,22,15,3340,19,19,100.0,Boric
2021-12-05 05:24:46.923710,7195,2170,False,1240,768,418,597,61,382,270,3736,31,11,3778,20,20,100.0,Boric
2021-12-05 05:24:46.923710,7195,2171,False,1517,797,363,626,71,307,245,3926,30,15,3971,21,21,100.0,Boric
2021-12-05 05:24:46.923710,7195,2172,False,1252,886,605,673,67,471,248,4202,44,22,4268,24,24,100.0,Boric
2021-12-05 05:24:46.923710,7195,2173,False,1599,887,435,855,85,409,318,4588,26,17,4631,24,24,100.0,Boric
2021-12-05 05:24:46.923710,7178,2003,False,1188,518,194,407,32,150,131,2620,11,2,2633,11,11,100.0,Boric
2021-12-05 05:24:46.923710,7178,2001,False,1348,492,233,404,54,139,182,2852,16,1,2869,13,13,100.0,Boric
2021-12-05 05:24:46.923710,7178,2002,False,646,506,206,370,26,140,57,1951,13,4,1968,14,14,100.0,Boric
2021-12-05 05:24:46.923710,7178,2017,False,686,546,203,413,37,166,98,2149,10,5,2164,13,13,100.0,Boric
2021-12-05 05:24:46.923710,7178,2004,False,1283,778,297,509,70,179,152,3268,15,6,3289,19,19,100.0,Boric
2021-12-05 05:24:46.923710,7178,2005,False,1144,908,430,580,70,296,165,3593,30,7,3630,24,24,100.0,Boric
2021-12-05 05:24:46.923710,7178,2006,False,1293,990,407,603,74,282,163,3812,18,8,3838,23,23,100.0,Boric
2021-12-05 05:24:46.923710,7178,2007,False,880,437,183,273,54,107,106,2040,15,7,2062,10,10,100.0,Boric
2021-12-05 05:24:46.923710,7178,2008,False,1418,711,394,559,77,201,163,3523,16,3,3542,18,18,100.0,Boric
2021-12-05 05:24:46.923710,7178,2009,False,1494,753,333,567,87,225,127,3586,19,5,3610,18,18,100.0,Boric
2021-12-05 05:24:46.923710,7178,2010,False,898,728,326,379,38,180,104,2653,15,7,2675,24,24,100.0,Boric
2021-12-05 05:24:46.923710,7178,2011,False,1585,842,408,619,100,327,229,4110,24,8,4142,24,24,100.0,Boric
2021-12-05 05:24:46.923710,7178,2012,False,701,539,206,332,33,163,100,2074,9,5,2088,13,13,100.0,Boric
2021-12-05 05:24:46.923710,7178,2018,False,726,519,201,328,39,154,116,2083,16,4,2103,13,13,100.0,Boric
2021-12-05 05:24:46.923710,7178,2013,False,603,519,204,347,33,144,62,1912,10,7,1929,16,16,100.0,Boric
2021-12-05 05:24:46.923710,7178,2014,False,674,563,212,364,29,161,94,2097,12,5,2114,16,16,100.0,Boric
2021-12-05 05:24:46.923710,7178,2015,False,1485,975,393,586,82,323,188,4032,23,9,4064,23,23,100.0,Boric
2021-12-05 05:24:46.923710,7178,2016,False,1824,989,466,561,100,263,164,4367,17,7,4391,21,21,100.0,Boric
2021-12-05 05:24:46.923710,7599,2702,False,115,294,79,65,14,36,339,942,9,9,960,10,10,100.0,Parisi
2021-12-05 05:24:46.923710,7599,2703,False,201,492,121,129,19,95,510,1567,28,23,1618,16,16,100.0,Parisi
2021-12-05 05:24:46.923710,7332,2796,False,643,1571,735,548,42,331,568,4438,52,45,4535,31,31,100.0,Kast
2021-12-05 05:24:46.923710,7444,1324,False,247,620,370,209,24,101,194,1765,23,8,1796,12,12,100.0,Kast
2021-12-05 05:24:46.923710,7444,1325,False,328,693,442,168,16,116,252,2015,14,14,2043,13,13,100.0,Kast
2021-12-05 05:24:46.923710,7221,2430,False,329,680,285,255,15,89,137,1790,22,11,1823,13,13,100.0,Kast
2021-12-05 05:24:46.923710,7221,2431,False,342,652,256,228,19,106,175,1778,14,17,1809,12,12,100.0,Kast
2021-12-05 05:24:46.923710,7262,658,False,76,147,132,73,5,14,27,474,5,9,488,4,4,100.0,Kast
2021-12-05 05:24:46.923710,7022,82,False,421,228,195,98,33,117,553,1645,18,18,1681,11,11,100.0,Parisi
2021-12-05 05:24:46.923710,7022,83,False,428,225,175,89,33,98,550,1598,24,7,1629,11,11,100.0,Parisi
2021-12-05 05:24:46.923710,7337,867,False,1072,1338,312,751,55,249,666,4443,20,12,4475,24,24,100.0,Kast
2021-12-05 05:24:46.923710,7337,868,False,1066,1083,301,648,70,199,742,4109,31,7,4147,25,25,100.0,Kast
2021-12-05 05:24:46.923710,7337,869,False,547,881,318,397,26,233,438,2840,20,7,2867,18,18,100.0,Kast
2021-12-05 05:24:46.923710,7337,870,False,634,1026,340,474,34,195,464,3167,15,5,3187,18,18,100.0,Kast
2021-12-05 05:24:46.923710,7337,871,False,714,1272,573,515,34,275,548,3931,38,17,3986,23,23,100.0,Kast
2021-12-05 05:24:46.923710,7337,872,False,683,911,210,417,37,156,641,3055,17,9,3081,18,18,100.0,Kast
2021-12-05 05:24:46.923710,7337,873,False,539,1028,394,461,22,247,390,3081,19,17,3117,20,20,100.0,Kast
2021-12-05 05:24:46.923710,7337,874,False,672,996,366,568,30,193,439,3264,22,7,3293,18,18,100.0,Kast
2021-12-05 05:24:46.923710,7337,875,False,606,929,362,384,40,206,508,3035,7,21,3063,20,20,100.0,Kast
2021-12-05 05:24:46.923710,7337,876,False,320,690,181,308,14,81,178,1772,3,3,1778,9,9,100.0,Kast
2021-12-05 05:24:46.923710,7337,877,False,727,1191,395,559,23,240,486,3621,22,7,3650,20,20,100.0,Kast
2021-12-05 05:24:46.923710,7337,878,False,413,755,326,355,27,187,289,2352,18,7,2377,15,15,100.0,Kast
2021-12-05 05:24:46.923710,7638,520,False,556,554,220,255,29,209,413,2236,18,5,2259,13,13,100.0,Boric
2021-12-05 05:24:46.923710,7279,740,False,590,1183,627,548,38,369,738,4093,43,32,4168,26,26,100.0,Kast
2021-12-05 05:24:46.923710,7176,1986,False,939,572,285,228,101,344,315,2784,21,14,2819,18,18,100.0,Boric
2021-12-05 05:24:46.923710,7176,1987,False,754,424,276,241,52,314,281,2342,13,9,2364,18,18,100.0,Boric
2021-12-05 05:24:46.923710,7176,1988,False,556,350,218,231,33,328,166,1882,16,5,1903,15,15,100.0,Boric
2021-12-05 05:24:46.923710,7176,1991,False,732,441,263,217,67,329,261,2310,16,7,2333,17,17,100.0,Boric
2021-12-05 05:24:46.923710,7176,1992,False,569,386,293,229,44,290,159,1970,24,9,2003,15,15,100.0,Boric
2021-12-05 05:24:46.923710,7176,1993,False,690,430,291,210,52,273,241,2187,28,14,2229,16,16,100.0,Boric
2021-12-05 05:24:46.923710,7176,1995,False,854,415,242,192,71,287,260,2321,20,10,2351,17,17,100.0,Boric
2021-12-05 05:24:46.923710,7176,1996,False,601,422,272,264,49,363,234,2205,20,11,2236,16,16,100.0,Boric
2021-12-05 05:24:46.923710,7176,1997,False,864,429,282,258,65,369,288,2555,17,6,2578,17,17,100.0,Boric
2021-12-05 05:24:46.923710,7176,1989,False,750,331,136,152,71,265,316,2021,16,9,2046,18,18,100.0,Boric
2021-12-05 05:24:46.923710,7176,1994,False,942,587,472,314,58,415,303,3091,39,26,3156,22,22,100.0,Boric
2021-12-05 05:24:46.923710,7176,1990,False,625,393,258,235,37,324,232,2104,13,10,2127,16,16,100.0,Boric
2021-12-05 05:24:46.923710,7176,1998,False,804,574,394,300,50,396,228,2746,26,17,2789,20,20,100.0,Boric
2021-12-05 05:24:46.923710,7176,1999,False,491,300,171,161,55,192,141,1511,24,5,1540,12,12,100.0,Boric
2021-12-05 05:24:46.923710,7176,2000,False,469,319,215,236,39,250,156,1684,15,13,1712,14,14,100.0,Boric
2021-12-05 05:24:46.923710,7651,1286,False,145,404,104,83,9,87,200,1032,6,7,1045,7,7,100.0,Kast
2021-12-05 05:24:46.923710,7369,1028,False,313,510,282,134,13,204,431,1887,28,18,1933,15,15,100.0,Kast
2021-12-05 05:24:46.923710,7237,589,False,824,1014,687,638,36,252,300,3751,173,18,3942,27,27,100.0,Kast
2021-12-05 05:24:46.923710,7237,590,False,317,382,390,220,15,105,143,1572,18,14,1604,12,12,100.0,Provoste
2021-12-05 05:24:46.923710,7237,591,False,545,410,183,247,23,117,227,1752,8,7,1767,13,13,100.0,Boric
2021-12-05 05:24:46.923710,7237,592,False,1069,1022,493,612,43,277,587,4103,31,17,4151,28,28,100.0,Boric
2021-12-05 05:24:46.923710,7237,593,False,1035,1171,838,583,60,267,454,4408,43,29,4480,30,30,100.0,Kast
2021-12-05 05:24:46.923710,7362,1010,False,187,675,227,208,18,78,239,1632,7,6,1645,13,13,100.0,Kast
2021-12-05 05:24:46.923710,7362,1011,False,179,665,238,190,14,58,240,1584,19,22,1625,12,12,100.0,Kast
2021-12-05 05:24:46.923710,7362,1012,False,279,742,205,185,15,89,386,1901,20,10,1931,14,14,100.0,Kast
2021-12-05 05:24:46.923710,7595,2802,False,113,307,174,135,9,47,107,892,20,10,922,7,7,100.0,Kast
2021-12-05 05:24:46.923710,7251,632,False,457,562,239,315,17,71,212,1873,13,3,1889,11,11,100.0,Kast
2021-12-05 05:24:46.923710,7251,633,False,324,408,287,328,16,107,176,1646,7,4,1657,12,12,100.0,Kast
2021-12-05 05:24:46.923710,7251,634,False,508,495,176,253,26,69,201,1728,9,4,1741,11,11,100.0,Boric
2021-12-05 05:24:46.923710,7251,635,False,609,741,496,505,28,135,266,2780,19,16,2815,20,20,100.0,Kast
2021-12-05 05:24:46.923710,7251,636,False,662,865,454,606,28,134,239,2988,20,17,3025,19,19,100.0,Kast
2021-12-05 05:24:46.923710,7251,637,False,452,738,397,530,15,148,197,2477,17,17,2511,19,19,100.0,Kast
2021-12-05 05:24:46.923710,7356,1000,False,166,1032,311,215,17,112,285,2138,42,21,2201,19,19,100.0,Kast
2021-12-05 05:24:46.923710,7350,947,False,191,348,76,78,20,49,165,927,8,6,941,7,7,100.0,Kast
2021-12-05 05:24:46.923710,7350,949,False,375,925,301,216,24,175,398,2414,25,12,2451,17,17,100.0,Kast
2021-12-05 05:24:46.923710,7350,948,False,320,882,261,130,27,117,284,2021,22,21,2064,15,15,100.0,Kast
2021-12-05 05:24:46.923710,7085,301,False,535,621,482,401,30,230,553,2852,38,19,2909,17,17,100.0,Kast
2021-12-05 05:24:46.923710,7085,302,False,614,722,535,369,29,219,588,3076,47,23,3146,19,19,100.0,Kast
2021-12-05 05:24:46.923710,7624,819,False,104,175,116,57,7,64,178,701,11,5,717,7,7,100.0,Parisi
2021-12-05 05:24:46.923710,7706,1089,False,25,54,26,12,0,11,21,149,2,0,151,1,1,100.0,Kast
2021-12-05 05:24:46.923710,7123,507,False,959,2481,592,1077,46,297,383,5835,36,13,5884,27,27,100.0,Kast
2021-12-05 05:24:46.923710,7123,506,False,322,519,236,256,12,98,120,1563,10,9,1582,8,8,100.0,Kast
2021-12-05 05:24:46.923710,7724,831,False,467,691,353,274,38,239,497,2559,22,21,2602,19,19,100.0,Kast
2021-12-05 05:24:46.923710,7104,405,False,400,669,105,314,11,64,92,1655,9,7,1671,10,10,100.0,Kast
2021-12-05 05:24:46.923710,7104,406,False,311,585,95,214,20,69,115,1409,7,5,1421,10,10,100.0,Kast
2021-12-05 05:24:46.923710,7104,407,False,1296,1318,181,490,95,219,690,4289,21,6,4316,31,31,100.0,Kast
2021-12-05 05:24:46.923710,7104,408,False,1129,1571,276,538,55,255,502,4326,23,7,4356,30,30,100.0,Kast
2021-12-05 05:24:46.923710,7104,409,False,661,927,312,364,44,179,211,2698,21,4,2723,21,21,100.0,Kast
2021-12-05 05:24:46.923710,7104,410,False,935,1465,377,683,52,244,291,4047,24,7,4078,30,30,100.0,Kast
2021-12-05 05:24:46.923710,7104,418,False,561,785,176,305,23,103,194,2147,11,5,2163,15,15,100.0,Kast
2021-12-05 05:24:46.923710,7104,411,False,874,1279,324,554,38,268,305,3642,17,9,3668,25,25,100.0,Kast
2021-12-05 05:24:46.923710,7104,412,False,794,805,183,360,43,126,288,2599,17,8,2624,19,19,100.0,Kast
2021-12-05 05:24:46.923710,7104,413,False,423,804,228,281,22,94,131,1983,14,7,2004,21,21,100.0,Kast
2021-12-05 05:24:46.923710,7104,414,False,970,1171,372,495,46,265,327,3646,22,9,3677,25,25,100.0,Kast
2021-12-05 05:24:46.923710,7104,415,False,640,1002,181,357,41,92,193,2506,21,6,2533,15,15,100.0,Kast
2021-12-05 05:24:46.923710,7104,416,False,1089,1770,312,698,68,251,398,4586,15,6,4607,31,31,100.0,Kast
2021-12-05 05:24:46.923710,7104,417,False,783,1417,349,629,32,154,200,3564,17,6,3587,30,30,100.0,Kast
2021-12-05 05:24:46.923710,7104,419,False,590,928,149,366,35,100,166,2334,6,8,2348,15,15,100.0,Kast
2021-12-05 05:24:46.923710,7303,810,False,23,193,30,44,1,16,10,317,0,2,319,2,2,100.0,Kast
2021-12-05 05:24:46.923710,7694,2715,False,378,579,229,137,22,143,582,2070,22,9,2101,13,13,100.0,Parisi
2021-12-05 05:24:46.923710,7694,2716,False,339,462,145,97,23,87,483,1636,18,7,1661,10,10,100.0,Parisi
2021-12-05 05:24:46.923710,7694,2717,False,477,695,271,197,25,155,677,2497,25,7,2529,15,15,100.0,Kast
2021-12-05 05:24:46.923710,7694,2718,False,271,424,171,100,14,104,466,1550,17,10,1577,10,10,100.0,Parisi
2021-12-05 05:24:46.923710,7694,2719,False,281,398,181,87,17,99,468,1531,24,10,1565,10,10,100.0,Parisi
2021-12-05 05:24:46.923710,7694,2720,False,373,506,193,131,15,107,579,1904,14,10,1928,12,12,100.0,Parisi
2021-12-05 05:24:46.923710,7694,2721,False,258,468,170,107,18,102,450,1573,9,10,1592,10,10,100.0,Kast
2021-12-05 05:24:46.923710,7694,2722,False,346,536,210,110,29,112,507,1850,19,5,1874,12,12,100.0,Kast
2021-12-05 05:24:46.923710,7694,2723,False,264,442,160,93,21,104,437,1521,21,7,1549,10,10,100.0,Kast
2021-12-05 05:24:46.923710,7694,2724,False,349,495,197,140,18,134,572,1905,23,5,1933,12,12,100.0,Parisi
2021-12-05 05:24:46.923710,7694,2725,False,200,312,136,81,15,60,305,1109,16,5,1130,7,7,100.0,Kast
2021-12-05 05:24:46.923710,7694,2726,False,279,440,182,97,22,93,469,1582,17,4,1603,10,10,100.0,Parisi
2021-12-05 05:24:46.923710,7389,1132,False,58,398,85,60,3,37,35,676,14,4,694,6,6,100.0,Kast
2021-12-05 05:24:46.923710,7028,128,False,71,88,46,15,3,49,152,424,3,0,427,6,6,100.0,Parisi
2021-12-05 05:24:46.923710,7615,133,False,31,44,33,12,2,12,82,216,1,0,217,3,3,100.0,Parisi
2021-12-05 05:24:46.923710,7666,2555,False,921,423,193,305,52,256,268,2418,34,0,2452,14,14,100.0,Boric
2021-12-05 05:24:46.923710,7666,2556,False,1000,387,199,325,51,247,271,2480,12,4,2496,14,14,100.0,Boric
2021-12-05 05:24:46.923710,7666,2557,False,1115,389,167,274,68,206,210,2429,19,6,2454,14,14,100.0,Boric
2021-12-05 05:24:46.923710,7666,2558,False,602,404,182,248,30,190,128,1784,7,2,1793,10,10,100.0,Boric
2021-12-05 05:24:46.923710,7666,2553,False,1144,375,152,293,108,211,210,2493,15,9,2517,14,14,100.0,Boric
2021-12-05 05:24:46.923710,7666,2554,False,1136,407,214,326,44,224,217,2568,8,5,2581,13,13,100.0,Boric
2021-12-05 05:24:46.923710,7666,2559,False,1022,409,210,344,76,239,221,2521,19,7,2547,13,13,100.0,Boric
2021-12-05 05:24:46.923710,7666,2560,False,1041,557,298,372,43,332,225,2868,14,3,2885,13,13,100.0,Boric
2021-12-05 05:24:46.923710,7666,2561,False,1038,521,256,373,67,300,343,2898,18,4,2920,16,16,100.0,Boric
2021-12-05 05:24:46.923710,7666,2562,False,1004,452,213,349,59,292,316,2685,29,4,2718,15,15,100.0,Boric
2021-12-05 05:24:46.923710,7666,2563,False,872,338,172,290,56,223,228,2179,18,7,2204,13,13,100.0,Boric
2021-12-05 05:24:46.923710,7666,2564,False,1076,489,216,345,57,278,280,2741,179,6,2926,16,16,100.0,Boric
2021-12-05 05:24:46.923710,7666,2551,False,907,426,191,314,44,206,165,2253,16,5,2274,13,13,100.0,Boric
2021-12-05 05:24:46.923710,7666,2552,False,1089,408,187,278,68,206,210,2446,24,9,2479,13,13,100.0,Boric
2021-12-05 05:24:46.923710,7222,2432,False,1206,694,212,337,86,231,517,3283,26,7,3316,20,20,100.0,Boric
2021-12-05 05:24:46.923710,7222,2433,False,1001,829,277,427,52,259,387,3232,15,10,3257,18,18,100.0,Boric
2021-12-05 05:24:46.923710,7222,2437,False,1017,1184,542,605,47,442,472,4309,42,18,4369,22,22,100.0,Kast
2021-12-05 05:24:46.923710,7222,2438,False,1144,737,264,380,65,312,712,3614,14,9,3637,21,21,100.0,Boric
2021-12-05 05:24:46.923710,7222,2434,False,579,917,464,414,26,352,252,3004,42,19,3065,18,18,100.0,Kast
2021-12-05 05:24:46.923710,7222,2435,False,597,714,367,322,31,329,290,2650,25,17,2692,15,15,100.0,Kast
2021-12-05 05:24:46.923710,7222,2436,False,1038,1071,368,411,56,313,436,3693,26,10,3729,18,18,100.0,Kast
2021-12-05 05:24:46.923710,7222,2439,False,880,1060,671,442,49,387,342,3831,53,35,3919,22,22,100.0,Kast
2021-12-05 05:24:46.923710,7222,2440,False,836,903,503,384,48,361,400,3435,35,22,3492,19,19,100.0,Kast
2021-12-05 05:24:46.923710,7276,716,False,759,1035,450,585,22,276,509,3636,43,12,3691,21,21,100.0,Kast
2021-12-05 05:24:46.923710,7276,717,False,1107,1391,508,516,46,261,682,4511,31,9,4551,23,23,100.0,Kast
2021-12-05 05:24:46.923710,7276,718,False,799,1173,564,653,27,285,503,4004,24,6,4034,23,23,100.0,Kast
2021-12-05 05:24:46.923710,7276,719,False,1153,803,174,415,55,164,926,3690,27,6,3723,23,23,100.0,Boric
2021-12-05 05:24:46.923710,7276,720,False,849,1098,555,514,39,240,492,3787,33,21,3841,22,22,100.0,Kast
2021-12-05 05:24:46.923710,7276,721,False,1147,790,282,412,59,191,640,3521,34,10,3565,22,22,100.0,Boric
2021-12-05 05:24:46.923710,7276,722,False,885,1196,485,672,31,295,577,4141,30,9,4180,23,23,100.0,Kast
2021-12-05 05:24:46.923710,7276,723,False,710,950,533,532,34,194,285,3238,31,7,3276,22,22,100.0,Kast
2021-12-05 05:24:46.923710,7276,724,False,870,854,312,522,28,175,304,3065,20,2,3087,14,14,100.0,Boric
2021-12-05 05:24:46.923710,7276,725,False,883,791,161,353,53,169,1001,3411,4,7,3422,23,23,100.0,Parisi
2021-12-05 05:24:46.923710,7276,726,False,1241,1054,352,529,55,220,737,4188,34,4,4226,24,24,100.0,Boric
2021-12-05 05:24:46.923710,7276,727,False,1240,1378,423,596,62,198,642,4539,18,15,4572,23,23,100.0,Kast
2021-12-05 05:24:46.923710,7276,728,False,1101,1376,642,758,41,368,639,4925,40,14,4979,26,26,100.0,Kast
2021-12-05 05:24:46.923710,7276,729,False,858,1194,473,528,36,270,647,4006,33,11,4050,22,22,100.0,Kast
2021-12-05 05:24:46.923710,7276,730,False,1696,2040,1155,1036,67,493,978,7465,59,35,7559,44,44,100.0,Kast
2021-12-05 05:24:46.923710,7276,731,False,839,1077,566,506,33,232,524,3777,28,21,3826,22,22,100.0,Kast
2021-12-05 05:24:46.923710,7276,732,False,671,952,459,498,41,264,357,3242,26,16,3284,20,20,100.0,Kast
2021-12-05 05:24:46.923710,7276,733,False,546,643,463,328,17,202,270,2469,28,8,2505,15,15,100.0,Kast
2021-12-05 05:24:46.923710,7276,734,False,1179,1316,552,781,40,279,576,4723,32,10,4765,23,23,100.0,Kast
2021-12-05 05:24:46.923710,7276,735,False,709,1042,527,525,38,299,459,3599,36,20,3655,23,23,100.0,Kast
2021-12-05 05:24:46.923710,7276,736,False,860,995,593,474,50,253,407,3632,27,10,3669,25,25,100.0,Kast
2021-12-05 05:24:46.923710,7276,737,False,2051,2219,802,1134,81,491,1235,8013,47,22,8082,49,49,100.0,Kast
2021-12-05 05:24:46.923710,7339,889,False,888,1478,280,321,82,201,730,3980,14,13,4007,30,30,100.0,Kast
2021-12-05 05:24:46.923710,7339,890,False,509,597,216,183,31,145,357,2038,24,8,2070,16,16,100.0,Kast
2021-12-05 05:24:46.923710,7339,891,False,784,949,303,396,39,229,480,3180,16,5,3201,19,19,100.0,Kast
2021-12-05 05:24:46.923710,7339,892,False,495,934,326,353,32,233,513,2886,23,8,2917,22,22,100.0,Kast
2021-12-05 05:24:46.923710,7339,893,False,528,495,200,187,32,111,352,1905,14,9,1928,12,12,100.0,Boric
2021-12-05 05:24:46.923710,7339,894,False,634,799,252,314,39,182,542,2762,18,8,2788,17,17,100.0,Kast
2021-12-05 05:24:46.923710,7339,895,False,542,912,134,202,40,114,496,2440,19,6,2465,22,22,100.0,Kast
2021-12-05 05:24:46.923710,7339,896,False,518,934,218,318,24,155,387,2554,24,3,2581,16,16,100.0,Kast
2021-12-05 05:24:46.923710,7339,897,False,341,546,98,132,27,96,326,1566,13,3,1582,16,16,100.0,Kast
2021-12-05 05:24:46.923710,7339,898,False,353,501,134,144,24,127,363,1646,17,5,1668,15,15,100.0,Kast
2021-12-05 05:24:46.923710,7339,899,False,475,711,293,313,25,198,458,2473,20,6,2499,18,18,100.0,Kast
2021-12-05 05:24:46.923710,7339,900,False,195,378,136,128,11,79,165,1092,10,0,1102,9,9,100.0,Kast
2021-12-05 05:24:46.923710,7339,901,False,623,883,236,221,39,172,474,2648,17,4,2669,22,22,100.0,Kast
2021-12-05 05:24:46.923710,7339,902,False,326,744,275,300,28,197,333,2203,26,12,2241,20,20,100.0,Kast
2021-12-05 05:24:46.923710,7339,903,False,437,584,213,230,24,150,404,2042,21,5,2068,15,15,100.0,Kast
2021-12-05 05:24:46.923710,7339,904,False,613,885,371,306,49,262,562,3048,30,16,3094,22,22,100.0,Kast
2021-12-05 05:24:46.923710,7339,905,False,460,801,308,257,30,199,414,2469,21,9,2499,22,22,100.0,Kast
2021-12-05 05:24:46.923710,7339,906,False,728,935,327,321,43,245,719,3318,32,6,3356,22,22,100.0,Kast
2021-12-05 05:24:46.923710,7339,907,False,672,854,342,288,36,198,590,2980,23,13,3016,20,20,100.0,Kast
2021-12-05 05:24:46.923710,7339,908,False,408,534,205,178,17,115,350,1807,19,4,1830,12,12,100.0,Kast
2021-12-05 05:24:46.923710,7349,946,False,149,310,158,84,12,108,194,1015,14,7,1036,9,9,100.0,Kast
2021-12-05 05:24:46.923710,7029,129,False,399,363,251,110,17,147,424,1711,17,10,1738,15,15,100.0,Parisi
2021-12-05 05:24:46.923710,7029,130,False,452,357,351,78,39,126,482,1885,16,12,1913,16,16,100.0,Parisi
2021-12-05 05:24:46.923710,7582,1419,False,102,208,221,55,7,29,54,676,5,9,690,5,5,100.0,Provoste
2021-12-05 05:24:46.923710,7395,1156,False,487,700,140,191,33,107,329,1987,11,6,2004,20,20,100.0,Kast
2021-12-05 05:24:46.923710,7395,1146,False,437,831,262,256,18,134,268,2206,23,11,2240,22,22,100.0,Kast
2021-12-05 05:24:46.923710,7395,1147,False,508,1080,289,326,34,201,397,2835,22,6,2863,25,25,100.0,Kast
2021-12-05 05:24:46.923710,7395,1148,False,383,932,321,253,27,162,321,2399,17,11,2427,25,25,100.0,Kast
2021-12-05 05:24:46.923710,7395,1149,False,418,824,208,264,22,161,292,2189,21,4,2214,20,20,100.0,Kast
2021-12-05 05:24:46.923710,7395,1150,False,400,821,261,241,15,135,316,2189,11,5,2205,22,22,100.0,Kast
2021-12-05 05:24:46.923710,7395,1151,False,440,869,231,281,27,173,338,2359,22,9,2390,20,20,100.0,Kast
2021-12-05 05:24:46.923710,7395,1157,False,176,385,77,106,12,41,118,915,7,4,926,10,10,100.0,Kast
2021-12-05 05:24:46.923710,7395,1152,False,339,717,235,204,22,149,278,1944,14,8,1966,18,18,100.0,Kast
2021-12-05 05:24:46.923710,7395,1154,False,445,754,184,205,35,135,328,2086,13,7,2106,20,20,100.0,Kast
2021-12-05 05:24:46.923710,7395,1155,False,576,1051,256,244,28,145,421,2721,22,7,2750,25,25,100.0,Kast
2021-12-05 05:24:46.923710,7395,1153,False,464,1007,304,328,18,184,283,2588,23,7,2618,25,25,100.0,Kast
2021-12-05 05:24:46.923710,7734,1298,False,552,1068,296,281,31,163,352,2743,18,12,2773,16,16,100.0,Kast
2021-12-05 05:24:46.923710,7734,1299,False,546,961,232,270,25,143,316,2493,21,5,2519,15,15,100.0,Kast
2021-12-05 05:24:46.923710,7734,1297,False,856,1647,453,485,46,229,534,4250,29,12,4291,25,25,100.0,Kast
2021-12-05 05:24:46.923710,7734,1300,False,830,1579,409,467,37,252,532,4106,21,15,4142,24,24,100.0,Kast
2021-12-05 05:24:46.923710,7733,1291,False,699,1319,361,428,36,182,487,3512,15,16,3543,20,20,100.0,Kast
2021-12-05 05:24:46.923710,7733,1292,False,539,1112,317,320,36,190,328,2842,15,6,2863,16,16,100.0,Kast
2021-12-05 05:24:46.923710,7733,1293,False,529,1083,302,353,17,156,345,2785,13,6,2804,16,16,100.0,Kast
2021-12-05 05:24:46.923710,7733,1296,False,558,920,259,315,29,159,331,2571,7,5,2583,15,15,100.0,Kast
2021-12-05 05:24:46.923710,7733,1294,False,839,1492,387,459,44,225,521,3967,22,7,3996,23,23,100.0,Kast
2021-12-05 05:24:46.923710,7733,1295,False,731,1450,387,430,38,213,441,3690,26,8,3724,21,21,100.0,Kast
2021-12-05 05:24:46.923710,7559,1409,False,46,79,42,29,2,13,30,241,1,3,245,3,3,100.0,Kast
2021-12-05 05:24:46.923710,7265,694,False,390,817,347,413,26,229,283,2505,26,24,2555,20,20,100.0,Kast
2021-12-05 05:24:46.923710,7265,695,False,638,934,244,398,40,226,605,3085,27,16,3128,22,22,100.0,Kast
2021-12-05 05:24:46.923710,7265,696,False,280,570,193,218,14,114,261,1650,11,13,1674,11,11,100.0,Kast
2021-12-05 05:24:46.923710,7265,697,False,376,806,444,348,25,207,291,2497,39,27,2563,20,20,100.0,Kast
2021-12-05 05:24:46.923710,7417,1243,False,182,803,191,308,14,77,194,1769,23,18,1810,15,15,100.0,Kast
2021-12-05 05:24:46.923710,7417,1244,False,204,751,200,254,6,88,178,1681,29,23,1733,16,16,100.0,Kast
2021-12-05 05:24:46.923710,7037,155,False,792,651,1045,280,44,251,1495,4558,30,16,4604,38,38,100.0,Parisi
2021-12-05 05:24:46.923710,7596,254,False,827,371,205,183,37,175,615,2413,8,3,2424,15,15,100.0,Boric
2021-12-05 05:24:46.923710,7596,253,False,985,727,588,402,46,423,643,3814,39,23,3876,24,24,100.0,Boric
2021-12-05 05:24:46.923710,7596,252,False,834,500,230,214,55,233,956,3022,17,5,3044,21,21,100.0,Parisi
2021-12-05 05:24:46.923710,7596,251,False,870,780,415,294,35,306,904,3604,22,14,3640,25,25,100.0,Parisi
2021-12-05 05:24:46.923710,7673,1289,False,84,429,87,83,5,50,143,881,19,9,909,7,7,100.0,Kast
2021-12-05 05:24:46.923710,7127,1582,False,373,316,140,138,22,106,226,1321,10,5,1336,12,12,100.0,Boric
2021-12-05 05:24:46.923710,7127,1583,False,542,469,231,285,20,217,241,2005,24,5,2034,17,17,100.0,Boric
2021-12-05 05:24:46.923710,7127,1584,False,458,336,175,154,16,133,165,1437,14,7,1458,12,12,100.0,Boric
2021-12-05 05:24:46.923710,7512,1555,False,24,71,8,19,1,23,22,168,2,1,171,3,3,100.0,Kast
2021-12-05 05:24:46.923710,7381,1059,False,360,1131,277,146,33,73,194,2214,33,25,2272,16,16,100.0,Kast
2021-12-05 05:24:46.923710,7381,1060,False,221,805,206,88,24,67,128,1539,14,19,1572,11,11,100.0,Kast
2021-12-05 05:24:46.923710,7285,754,False,29,59,56,38,1,3,17,203,2,2,207,2,2,100.0,Kast
2021-12-05 05:24:46.923710,7016,56,False,466,376,319,180,37,212,1130,2720,26,16,2762,22,22,100.0,Parisi
2021-12-05 05:24:46.923710,7016,57,False,498,414,308,194,30,259,1195,2898,28,7,2933,25,25,100.0,Parisi
2021-12-05 05:24:46.923710,7016,58,False,544,399,286,103,38,180,1119,2669,23,11,2703,22,22,100.0,Parisi
2021-12-05 05:24:46.923710,7344,935,False,427,636,407,227,17,132,317,2163,16,18,2197,15,15,100.0,Kast
2021-12-05 05:24:46.923710,7344,930,False,542,541,135,123,33,95,433,1902,15,1,1918,13,13,100.0,Boric
2021-12-05 05:24:46.923710,7344,931,False,491,657,345,205,24,119,317,2158,15,5,2178,15,15,100.0,Kast
2021-12-05 05:24:46.923710,7344,932,False,650,912,441,320,24,222,504,3073,19,5,3097,18,18,100.0,Kast
2021-12-05 05:24:46.923710,7344,933,False,591,789,405,289,36,192,436,2738,23,10,2771,18,18,100.0,Kast
2021-12-05 05:24:46.923710,7344,934,False,457,547,195,113,17,95,429,1853,9,21,1883,13,13,100.0,Kast
2021-12-05 05:24:46.923710,7344,936,False,865,969,502,277,38,204,596,3451,33,14,3498,23,23,100.0,Kast
2021-12-05 05:24:46.923710,7344,937,False,523,800,462,291,26,193,348,2643,31,14,2688,20,20,100.0,Kast
2021-12-05 05:24:46.923710,7373,1034,False,66,250,89,57,6,29,76,573,7,8,588,5,5,100.0,Kast
2021-12-05 05:24:46.923710,7049,203,False,764,536,369,324,50,173,503,2719,23,24,2766,20,20,100.0,Boric
2021-12-05 05:24:46.923710,7504,1518,False,123,161,123,42,4,67,74,594,8,8,610,6,6,100.0,Kast
2021-12-05 05:24:46.923710,7502,1501,False,67,39,35,20,8,15,14,198,10,7,215,2,2,100.0,Boric
2021-12-05 05:24:46.923710,7390,1133,False,285,845,224,192,25,106,113,1790,20,19,1829,13,13,100.0,Kast
2021-12-05 05:24:46.923710,7390,1134,False,311,829,232,151,26,92,123,1764,24,11,1799,15,15,100.0,Kast
2021-12-05 05:24:46.923710,7390,1135,False,225,637,136,98,19,59,101,1275,19,13,1307,11,11,100.0,Kast
2021-12-05 05:24:46.923710,7390,1136,False,223,749,186,169,13,82,80,1502,21,10,1533,13,13,100.0,Kast
2021-12-05 05:24:46.923710,7390,1137,False,229,770,213,143,22,92,102,1571,29,13,1613,13,13,100.0,Kast
2021-12-05 05:24:46.923710,7328,2790,False,219,441,306,159,11,61,193,1390,5,16,1411,11,11,100.0,Kast
2021-12-05 05:24:46.923710,7328,2791,False,179,464,251,151,9,56,145,1255,17,11,1283,9,9,100.0,Kast
2021-12-05 05:24:46.923710,7669,824,False,140,277,199,88,11,70,124,909,9,6,924,7,7,100.0,Kast
2021-12-05 05:24:46.923710,7186,2075,False,1915,952,508,756,80,353,272,4836,31,8,4875,24,24,100.0,Boric
2021-12-05 05:24:46.923710,7186,2076,False,1059,872,424,609,47,317,167,3495,25,11,3531,21,21,100.0,Boric
2021-12-05 05:24:46.923710,7186,2077,False,1154,843,403,652,49,346,231,3678,23,12,3713,21,21,100.0,Boric
2021-12-05 05:24:46.923710,7186,2081,False,1153,508,194,373,61,229,217,2735,18,4,2757,16,16,100.0,Boric
2021-12-05 05:24:46.923710,7186,2080,False,800,429,174,349,30,143,105,2030,5,7,2042,10,10,100.0,Boric
2021-12-05 05:24:46.923710,7186,2088,False,886,547,311,353,32,207,152,2488,16,8,2512,14,14,100.0,Boric
2021-12-05 05:24:46.923710,7186,2082,False,1566,929,397,574,81,288,242,4077,20,12,4109,19,19,100.0,Boric
2021-12-05 05:24:46.923710,7186,2083,False,1388,530,186,350,70,196,233,2953,23,7,2983,16,16,100.0,Boric
2021-12-05 05:24:46.923710,7186,2084,False,1146,688,339,471,52,277,210,3183,23,2,3208,20,20,100.0,Boric
2021-12-05 05:24:46.923710,7186,2085,False,1177,626,265,474,64,299,231,3136,24,6,3166,20,20,100.0,Boric
2021-12-05 05:24:46.923710,7186,2078,False,841,675,392,446,30,269,141,2794,24,19,2837,17,17,100.0,Boric
2021-12-05 05:24:46.923710,7186,2079,False,975,671,418,495,43,289,171,3062,36,16,3114,17,17,100.0,Boric
2021-12-05 05:24:46.923710,7186,2086,False,1152,709,382,433,50,299,213,3238,23,18,3279,18,18,100.0,Boric
2021-12-05 05:24:46.923710,7186,2087,False,1334,751,361,516,58,320,232,3572,19,12,3603,18,18,100.0,Boric
2021-12-05 05:24:46.923710,7421,1252,False,102,813,188,152,9,58,86,1408,10,12,1430,13,13,100.0,Kast
2021-12-05 05:24:46.923710,7659,1084,False,36,66,51,43,4,18,25,243,5,6,254,2,2,100.0,Kast
2021-12-05 05:24:46.923710,7698,1086,False,22,161,23,11,0,14,45,276,3,1,280,2,2,100.0,Kast
2021-12-05 05:24:46.923710,7359,1007,False,300,632,273,176,11,86,443,1921,25,15,1961,14,14,100.0,Kast
2021-12-05 05:24:46.923710,7358,1005,False,231,521,278,183,14,94,348,1669,11,15,1695,14,14,100.0,Kast
2021-12-05 05:24:46.923710,7358,1006,False,198,463,237,129,15,65,262,1369,9,14,1392,13,13,100.0,Kast
2021-12-05 05:24:46.923710,7425,2577,False,652,562,300,209,43,147,229,2142,22,7,2171,13,13,100.0,Boric
2021-12-05 05:24:46.923710,7425,2578,False,845,870,341,351,39,231,407,3084,25,12,3121,17,17,100.0,Kast
2021-12-05 05:24:46.923710,7425,2603,False,888,770,396,275,39,150,270,2788,19,18,2825,17,17,100.0,Boric
2021-12-05 05:24:46.923710,7425,2579,False,567,601,288,230,27,117,176,2006,25,13,2044,16,16,100.0,Kast
2021-12-05 05:24:46.923710,7425,2580,False,357,375,181,141,14,90,146,1304,8,4,1316,8,8,100.0,Kast
2021-12-05 05:24:46.923710,7425,2604,False,794,782,344,336,29,172,289,2746,21,12,2779,15,15,100.0,Boric
2021-12-05 05:24:46.923710,7425,2581,False,968,740,217,297,44,127,484,2877,17,5,2899,17,17,100.0,Boric
2021-12-05 05:24:46.923710,7425,2582,False,673,711,328,286,32,187,258,2475,15,13,2503,15,15,100.0,Kast
2021-12-05 05:24:46.923710,7425,2583,False,806,705,313,267,56,164,356,2667,15,12,2694,15,15,100.0,Boric
2021-12-05 05:24:46.923710,7425,2584,False,406,387,101,116,22,59,132,1223,5,7,1235,6,6,100.0,Boric
2021-12-05 05:24:46.923710,7425,2585,False,393,334,172,157,25,96,148,1325,7,1,1333,8,8,100.0,Boric
2021-12-05 05:24:46.923710,7425,2586,False,941,655,194,245,45,97,276,2453,7,6,2466,14,14,100.0,Boric
2021-12-05 05:24:46.923710,7425,2587,False,904,885,321,291,48,187,409,3045,18,14,3077,17,17,100.0,Boric
2021-12-05 05:24:46.923710,7425,2588,False,795,712,255,229,27,95,262,2375,8,12,2395,12,12,100.0,Boric
2021-12-05 05:24:46.923710,7425,2589,False,544,551,265,212,25,133,214,1944,20,8,1972,12,12,100.0,Kast
2021-12-05 05:24:46.923710,7425,2590,False,853,804,368,318,54,175,323,2895,18,7,2920,16,16,100.0,Boric
2021-12-05 05:24:46.923710,7425,2591,False,622,346,69,120,45,49,349,1600,12,3,1615,11,11,100.0,Boric
2021-12-05 05:24:46.923710,7425,2592,False,729,870,433,332,36,203,272,2875,29,6,2910,17,17,100.0,Kast
2021-12-05 05:24:46.923710,7425,2593,False,599,473,232,157,24,113,247,1845,11,13,1869,11,11,100.0,Boric
2021-12-05 05:24:46.923710,7425,2594,False,443,403,186,136,25,79,160,1432,13,5,1450,8,8,100.0,Boric
2021-12-05 05:24:46.923710,7425,2595,False,725,863,368,344,45,190,259,2794,22,14,2830,19,19,100.0,Kast
2021-12-05 05:24:46.923710,7425,2596,False,787,789,405,288,37,178,327,2811,27,17,2855,16,16,100.0,Kast
2021-12-05 05:24:46.923710,7425,2597,False,793,781,424,276,53,160,288,2775,17,8,2800,17,17,100.0,Boric
2021-12-05 05:24:46.923710,7425,2598,False,406,391,129,128,21,51,118,1244,8,2,1254,6,6,100.0,Boric
2021-12-05 05:24:46.923710,7425,2599,False,751,731,288,286,27,155,271,2509,12,11,2532,16,16,100.0,Boric
2021-12-05 05:24:46.923710,7425,2600,False,459,512,274,223,31,172,148,1819,16,10,1845,12,12,100.0,Kast
2021-12-05 05:24:46.923710,7425,2601,False,323,346,203,158,14,93,90,1227,8,4,1239,8,8,100.0,Kast
2021-12-05 05:24:46.923710,7425,2602,False,1017,944,392,412,33,198,333,3329,18,11,3358,17,17,100.0,Boric
2021-12-05 05:24:46.923710,7763,2567,False,757,1037,331,355,42,294,536,3352,220,19,3591,23,23,100.0,Kast
2021-12-05 05:24:46.923710,7663,2543,False,981,731,217,508,36,263,286,3022,13,6,3041,13,13,100.0,Boric
2021-12-05 05:24:46.923710,7663,2544,False,877,710,151,440,36,236,294,2744,14,3,2761,12,12,100.0,Boric
2021-12-05 05:24:46.923710,7637,1509,False,61,109,64,34,3,9,17,297,4,4,305,2,2,100.0,Kast
2021-12-05 05:24:46.923710,7038,156,False,320,419,1322,184,18,78,429,2770,20,6,2796,21,21,100.0,Provoste
2021-12-05 05:24:46.923710,7038,157,False,549,418,1416,197,30,88,751,3449,22,12,3483,22,22,100.0,Provoste
2021-12-05 05:24:46.923710,7038,158,False,421,467,1363,171,29,77,556,3084,17,20,3121,22,22,100.0,Provoste
2021-12-05 05:24:46.923710,7038,159,False,478,425,1480,163,32,90,609,3277,17,12,3306,22,22,100.0,Provoste
2021-12-05 05:24:46.923710,7038,160,False,589,534,1317,160,33,94,798,3525,11,3,3539,22,22,100.0,Provoste
2021-12-05 05:24:46.923710,7038,161,False,406,471,1421,223,28,86,693,3328,21,10,3359,22,22,100.0,Provoste
2021-12-05 05:24:46.923710,7647,2806,False,23,123,34,19,3,9,16,227,2,16,245,2,2,100.0,Kast
2021-12-05 05:24:46.923710,7767,529,False,470,327,237,241,36,193,209,1713,9,5,1727,10,10,100.0,Boric
2021-12-05 05:24:46.923710,7767,530,False,707,380,189,236,32,212,398,2154,16,7,2177,13,13,100.0,Boric
2021-12-05 05:24:46.923710,7274,713,False,253,483,235,435,15,75,124,1620,11,11,1642,14,14,100.0,Kast
2021-12-05 05:24:46.923710,7388,1126,False,224,1056,167,176,9,84,133,1849,12,5,1866,12,12,100.0,Kast
2021-12-05 05:24:46.923710,7388,1127,False,242,1332,217,171,17,117,158,2254,20,6,2280,15,15,100.0,Kast
2021-12-05 05:24:46.923710,7388,1128,False,243,1070,128,126,21,78,170,1836,12,11,1859,14,14,100.0,Kast
2021-12-05 05:24:46.923710,7388,1129,False,232,1257,236,150,20,118,130,2143,17,14,2174,17,17,100.0,Kast
2021-12-05 05:24:46.923710,7388,1130,False,327,1472,201,159,23,118,188,2488,19,12,2519,18,18,100.0,Kast
2021-12-05 05:24:46.923710,7388,1131,False,226,1268,238,210,12,114,120,2188,21,8,2217,18,18,100.0,Kast
2021-12-05 05:24:46.923710,7051,208,False,705,394,284,180,50,111,550,2274,13,9,2296,19,19,100.0,Boric
2021-12-05 05:24:46.923710,7051,207,False,838,690,874,269,39,208,597,3515,60,34,3609,26,26,100.0,Provoste
2021-12-05 05:24:46.923710,7051,206,False,712,661,810,373,35,218,525,3334,46,19,3399,25,25,100.0,Provoste
2021-12-05 05:24:46.923710,7668,823,False,134,224,179,122,10,71,82,822,14,6,842,6,6,100.0,Kast
2021-12-05 05:24:46.923710,7402,1197,False,332,1196,487,312,24,129,250,2730,31,31,2792,19,19,100.0,Kast
2021-12-05 05:24:46.923710,7402,1198,False,381,1022,236,280,23,111,399,2452,18,13,2483,18,18,100.0,Kast
2021-12-05 05:24:46.923710,7402,1199,False,302,1132,447,311,24,133,241,2590,25,20,2635,19,19,100.0,Kast
2021-12-05 05:24:46.923710,7298,795,False,447,1024,450,487,22,214,302,2946,24,13,2983,20,20,100.0,Kast
2021-12-05 05:24:46.923710,7298,796,False,517,1032,487,358,20,182,334,2930,32,26,2988,21,21,100.0,Kast
2021-12-05 05:24:46.923710,7114,467,False,651,443,111,168,51,119,265,1808,11,7,1826,11,11,100.0,Boric
2021-12-05 05:24:46.923710,7114,468,False,1873,1689,433,682,116,395,815,6003,37,17,6057,30,30,100.0,Boric
2021-12-05 05:24:46.923710,7114,469,False,1143,793,194,282,82,197,502,3193,16,10,3219,19,19,100.0,Boric
2021-12-05 05:24:46.923710,7114,470,False,1580,973,218,395,87,276,926,4455,30,11,4496,28,28,100.0,Boric
2021-12-05 05:24:46.923710,7114,471,False,809,1010,377,383,54,277,310,3220,31,7,3258,22,22,100.0,Kast
2021-12-05 05:24:46.923710,7114,472,False,1590,2073,434,587,86,379,722,5871,35,13,5919,29,29,100.0,Kast
2021-12-05 05:24:46.923710,7114,473,False,1379,1558,423,634,65,349,560,4968,33,6,5007,25,25,100.0,Kast
2021-12-05 05:24:46.923710,7114,474,False,966,1274,408,519,62,380,468,4077,31,5,4113,25,25,100.0,Kast
2021-12-05 05:24:46.923710,7114,477,False,1062,1255,355,531,60,397,530,4190,38,9,4237,24,24,100.0,Kast
2021-12-05 05:24:46.923710,7114,478,False,1174,1557,420,497,66,377,529,4620,32,14,4666,26,26,100.0,Kast
2021-12-05 05:24:46.923710,7114,475,False,1031,1468,467,593,62,429,433,4483,41,9,4533,30,30,100.0,Kast
2021-12-05 05:24:46.923710,7114,476,False,1093,1250,525,483,61,375,485,4272,31,17,4320,24,24,100.0,Kast
2021-12-05 05:24:46.923710,7741,1511,False,21,23,14,10,2,7,15,92,4,0,96,1,1,100.0,Kast
2021-12-05 05:24:46.923710,7636,1508,False,51,114,37,50,3,16,23,294,4,7,305,3,3,100.0,Kast
2021-12-05 05:24:46.923710,7740,1510,False,23,55,61,13,3,19,10,184,4,1,189,2,2,100.0,Provoste
2021-12-05 05:24:46.923710,7270,708,False,213,415,236,247,11,73,125,1320,18,15,1353,10,10,100.0,Kast
2021-12-05 05:24:46.923710,7482,1398,False,4,34,10,14,1,4,5,72,2,1,75,1,1,100.0,Kast
2021-12-05 05:24:46.923710,7409,1215,False,484,1040,279,318,18,131,277,2547,19,5,2571,17,17,100.0,Kast
2021-12-05 05:24:46.923710,7409,1216,False,456,795,128,202,32,90,418,2121,12,6,2139,15,15,100.0,Kast
2021-12-05 05:24:46.923710,7409,1217,False,346,479,101,133,10,54,182,1305,11,9,1325,10,10,100.0,Kast
2021-12-05 05:24:46.923710,7409,1218,False,290,838,304,228,15,85,153,1913,19,21,1953,15,15,100.0,Kast
2021-12-05 05:24:46.923710,7409,1219,False,574,1131,251,290,26,131,322,2725,23,8,2756,16,16,100.0,Kast
2021-12-05 05:24:46.923710,7409,1220,False,216,581,180,177,16,65,116,1351,15,12,1378,12,12,100.0,Kast
2021-12-05 05:24:46.923710,7409,1221,False,351,860,286,236,23,99,188,2043,18,16,2077,14,14,100.0,Kast
2021-12-05 05:24:46.923710,7409,1222,False,447,1062,297,324,20,121,288,2559,20,14,2593,16,16,100.0,Kast
2021-12-05 05:24:46.923710,7409,1223,False,364,984,296,293,34,94,182,2247,19,18,2284,17,17,100.0,Kast
2021-12-05 05:24:46.923710,7409,1224,False,1032,939,226,325,48,171,319,3060,14,5,3079,16,16,100.0,Boric
2021-12-05 05:24:46.923710,7204,2258,False,238,1822,181,1100,4,36,18,3399,9,3,3411,20,20,100.0,Kast
2021-12-05 05:24:46.923710,7204,2259,False,268,1993,220,1301,7,31,20,3840,12,6,3858,20,20,100.0,Kast
2021-12-05 05:24:46.923710,7204,2260,False,393,2780,320,2107,11,37,23,5671,13,13,5697,24,24,100.0,Kast
2021-12-05 05:24:46.923710,7204,2261,False,428,2880,366,1743,18,38,23,5496,24,13,5533,24,24,100.0,Kast
2021-12-05 05:24:46.923710,7204,2262,False,420,3028,309,2264,12,37,34,6104,26,8,6138,24,24,100.0,Kast
2021-12-05 05:24:46.923710,7204,2263,False,200,1586,173,1081,4,16,16,3076,7,5,3088,12,12,100.0,Kast
2021-12-05 05:24:46.923710,7204,2264,False,401,2490,271,1619,10,26,32,4849,18,6,4873,22,22,100.0,Kast
2021-12-05 05:24:46.923710,7204,2265,False,476,3018,343,1799,7,39,26,5708,19,14,5741,24,24,100.0,Kast
2021-12-05 05:24:46.923710,7204,2266,False,415,3102,363,2002,14,31,14,5941,17,12,5970,24,24,100.0,Kast
2021-12-05 05:24:46.923710,7204,2267,False,340,2352,306,1747,4,34,13,4796,18,12,4826,20,20,100.0,Kast
2021-12-05 05:24:46.923710,7204,2268,False,361,2665,321,1932,6,23,12,5320,18,6,5344,21,21,100.0,Kast
2021-12-05 05:24:46.923710,7204,2270,False,201,1227,164,986,7,16,5,2606,5,5,2616,10,10,100.0,Kast
2021-12-05 05:24:46.923710,7204,2269,False,314,2272,259,1257,6,37,18,4163,20,7,4190,20,20,100.0,Kast
2021-12-05 05:24:46.923710,7292,776,False,242,498,213,134,17,112,200,1416,24,10,1450,11,11,100.0,Kast
2021-12-05 05:24:46.923710,7292,777,False,172,423,261,144,12,106,115,1233,25,20,1278,10,10,100.0,Kast
2021-12-05 05:24:46.923710,7292,778,False,402,939,442,347,29,211,291,2661,33,28,2722,20,20,100.0,Kast
2021-12-05 05:24:46.923710,7370,1029,False,334,649,278,172,23,79,280,1815,27,20,1862,15,15,100.0,Kast
2021-12-05 05:24:46.923710,7370,1030,False,409,947,283,211,31,142,411,2434,22,16,2472,17,17,100.0,Kast
2021-12-05 05:24:46.923710,7370,1031,False,273,738,268,184,12,96,261,1832,17,10,1859,15,15,100.0,Kast
2021-12-05 05:24:46.923710,7639,1079,False,168,375,141,71,9,66,214,1044,12,6,1062,7,7,100.0,Kast
2021-12-05 05:24:46.923710,7320,2774,False,541,860,495,284,36,155,586,2957,30,22,3009,22,22,100.0,Kast
2021-12-05 05:24:46.923710,7320,2775,False,468,882,486,324,25,163,572,2920,26,20,2966,21,21,100.0,Kast
2021-12-05 05:24:46.923710,7075,269,False,735,1298,302,1045,19,182,245,3826,21,10,3857,19,19,100.0,Kast
2021-12-05 05:24:46.923710,7238,594,False,175,284,194,162,11,66,80,972,7,6,985,9,9,100.0,Kast
