ts,idservel,c1,c2,c3,c4,c5,c6,c7,vv,vn,vb,vt,me,tm,cm,w1V
2021-12-05 05:17:27.574579,8000,1867,344,134,252,62,47,65,2771,18,9,2798,15,15,100.0,Boric
2021-12-05 05:17:27.574579,8001,1396,506,237,157,83,145,85,2609,28,6,2643,30,30,100.0,Boric
2021-12-05 05:17:27.574579,8002,1493,428,133,270,50,86,112,2572,15,10,2597,15,15,100.0,Boric
2021-12-05 05:17:27.574579,8003,134,36,20,18,3,5,9,225,3,0,228,1,1,100.0,Boric
2021-12-05 05:17:27.574579,8004,475,45,43,59,26,20,9,677,0,2,679,3,3,100.0,Boric
2021-12-05 05:17:27.574579,8005,46,209,23,20,4,6,13,321,1,1,323,3,3,100.0,Kast
2021-12-05 05:17:27.574579,8006,305,188,43,44,6,8,19,613,1,2,616,7,7,100.0,Boric
2021-12-05 05:17:27.574579,8007,1860,370,166,217,80,89,119,2901,7,1,2909,17,17,100.0,Boric
2021-12-05 05:17:27.574579,8008,54,96,14,40,1,7,4,216,0,0,216,1,1,100.0,Kast
2021-12-05 05:17:27.574579,8009,38,4,5,4,1,0,2,54,1,0,55,1,1,100.0,Boric
2021-12-05 05:17:27.574579,8010,128,89,19,35,3,4,8,286,2,0,288,2,2,100.0,Boric
2021-12-05 05:17:27.574579,8011,12,13,3,7,0,1,0,36,0,0,36,1,1,100.0,Kast
2021-12-05 05:17:27.574579,8012,45,1,3,1,2,2,0,54,0,1,55,1,1,100.0,Boric
2021-12-05 05:17:27.574579,8013,144,19,11,28,1,6,8,217,1,0,218,1,1,100.0,Boric
2021-12-05 05:17:27.574579,8014,134,222,29,55,4,10,8,462,1,0,463,4,4,100.0,Kast
2021-12-05 05:17:27.574579,8015,7,1,1,0,0,2,0,11,0,0,11,1,1,100.0,Boric
2021-12-05 05:17:27.574579,8016,1,10,1,5,0,0,0,17,0,0,17,1,1,100.0,Kast
2021-12-05 05:17:27.574579,8017,11,30,4,11,0,1,0,57,0,0,57,1,1,100.0,Kast
2021-12-05 05:17:27.574579,8018,16,15,0,12,0,0,1,44,0,1,45,1,1,100.0,Boric
2021-12-05 05:17:27.574579,8019,2402,556,235,436,85,63,104,3881,22,11,3914,24,24,100.0,Boric
2021-12-05 05:17:27.574579,8020,1639,1846,322,911,26,81,88,4913,4,6,4923,31,31,100.0,Kast
2021-12-05 05:17:27.574579,8021,13,11,0,3,0,1,1,29,0,0,29,1,1,100.0,Boric
2021-12-05 05:17:27.574579,8022,1,4,1,2,1,0,1,10,0,0,10,1,1,100.0,Kast
2021-12-05 05:17:27.574579,8023,82,27,6,13,5,2,5,140,3,0,143,1,1,100.0,Boric
2021-12-05 05:17:27.574579,8024,1013,97,82,108,41,26,26,1393,7,2,1402,9,9,100.0,Boric
2021-12-05 05:17:27.574579,8025,18,12,4,0,0,3,1,38,0,0,38,1,1,100.0,Boric
2021-12-05 05:17:27.574579,8026,24,50,8,12,0,0,1,95,0,0,95,1,1,100.0,Kast
2021-12-05 05:17:27.574579,8027,0,0,0,0,0,0,0,0,0,0,0,0,0,0.0,Boric
2021-12-05 05:17:27.574579,8028,5,14,5,1,0,3,1,29,0,0,29,1,1,100.0,Kast
2021-12-05 05:17:27.574579,8029,52,15,4,2,0,1,2,76,1,0,77,1,1,100.0,Boric
2021-12-05 05:17:27.574579,8030,4,3,3,0,0,1,0,11,0,1,12,1,1,100.0,Boric
2021-12-05 05:17:27.574579,8031,2,2,0,2,0,0,0,6,0,0,6,1,1,100.0,Boric
2021-12-05 05:17:27.574579,8032,158,23,16,22,4,5,11,239,2,0,241,1,1,100.0,Boric
2021-12-05 05:17:27.574579,8033,15,40,11,18,0,0,0,84,1,0,85,1,1,100.0,Kast
2021-12-05 05:17:27.574579,8034,254,145,35,70,17,6,16,543,6,0,549,4,4,100.0,Boric
2021-12-05 05:17:27.574579,8035,2,3,0,2,0,0,0,7,0,0,7,1,1,100.0,Kast
2021-12-05 05:17:27.574579,8036,54,13,3,17,6,3,10,106,2,0,108,1,1,100.0,Boric
2021-12-05 05:17:27.574579,8037,2,2,0,2,0,0,4,10,0,0,10,1,1,100.0,Parisi
2021-12-05 05:17:27.574579,8038,5,1,2,3,0,0,0,11,0,0,11,1,1,100.0,Boric
2021-12-05 05:17:27.574579,8039,5,7,2,2,0,2,0,18,0,0,18,1,1,100.0,Kast
2021-12-05 05:17:27.574579,8040,2,3,2,0,0,0,0,7,0,0,7,1,1,100.0,Kast
2021-12-05 05:17:27.574579,8041,291,126,43,59,9,4,8,540,2,1,543,3,3,100.0,Boric
2021-12-05 05:17:27.574579,8042,23,13,6,5,1,2,1,51,1,0,52,1,1,100.0,Boric
2021-12-05 05:17:27.574579,8043,119,17,8,6,3,7,7,167,1,0,168,1,1,100.0,Boric
2021-12-05 05:17:27.574579,8044,417,74,23,53,11,36,85,699,5,2,706,5,5,100.0,Boric
2021-12-05 05:17:27.574579,8045,376,74,55,94,11,15,17,642,4,2,648,3,3,100.0,Boric
2021-12-05 05:17:27.574579,8046,67,101,9,39,0,4,6,226,2,0,228,1,1,100.0,Kast
2021-12-05 05:17:27.574579,8047,43,126,10,24,0,3,2,208,0,0,208,1,1,100.0,Kast
2021-12-05 05:17:27.574579,8048,118,337,33,105,4,12,17,626,2,1,629,4,4,100.0,Kast
2021-12-05 05:17:27.574579,8049,23,11,3,11,3,0,5,56,0,0,56,1,1,100.0,Boric
2021-12-05 05:17:27.574579,8050,144,17,5,36,4,3,3,212,1,0,213,1,1,100.0,Boric
2021-12-05 05:17:27.574579,8051,711,230,130,251,18,8,22,1370,4,2,1376,7,7,100.0,Boric
2021-12-05 05:17:27.574579,8052,42,15,6,7,1,1,3,75,1,0,76,1,1,100.0,Boric
2021-12-05 05:17:27.574579,8053,24,50,7,17,1,2,3,104,0,0,104,1,1,100.0,Kast
2021-12-05 05:17:27.574579,8054,47,57,12,41,1,4,3,165,0,0,165,4,4,100.0,Kast
2021-12-05 05:17:27.574579,8055,8,2,0,1,0,0,2,13,2,0,15,1,1,100.0,Boric
2021-12-05 05:17:27.574579,8057,16,17,3,18,0,0,1,55,2,0,57,1,1,100.0,Sichel
2021-12-05 05:17:27.574579,8058,5,10,0,3,0,0,0,18,0,0,18,1,1,100.0,Kast
2021-12-05 05:17:27.574579,8059,1178,61,76,42,78,69,49,1553,7,3,1563,9,9,100.0,Boric
2021-12-05 05:17:27.574579,8060,379,104,34,63,17,8,22,627,2,1,630,4,4,100.0,Boric
2021-12-05 05:17:27.574579,8061,9,6,2,3,0,0,2,22,0,0,22,1,1,100.0,Boric
2021-12-05 05:17:27.574579,8062,6,2,2,3,0,0,0,13,0,0,13,1,1,100.0,Boric
2021-12-05 05:17:27.574579,8063,133,40,21,28,8,11,4,245,2,1,248,1,1,100.0,Boric
2021-12-05 05:17:27.574579,8064,74,180,38,26,7,4,1,330,0,0,330,3,3,100.0,Kast
2021-12-05 05:17:27.574579,8065,2,2,0,1,0,0,1,6,0,0,6,1,1,100.0,Boric
