cloc,cmesa,mesa,c1,c2,c3,c4,c5,c6,c7,vv,vn,vb,vtc,vts,w1V,obs
2678,70011228,228V-259V,30,59,9,11,4,4,52,169,1,0,170,169,Kast,
2682,70011091,91V-92V,25,42,17,12,2,5,37,140,1,0,141,142,Kast,
2682,70011110,110V-111V,27,37,13,11,2,13,33,136,1,1,138,148,Kast,
2685,70010196,196M-197M,26,56,12,11,2,5,45,157,0,0,157,158,Kast,
2685,70010215,215M-216M,30,61,24,8,1,13,36,173,2,1,176,177,Kast,
2706,76602022,22,22,38,21,9,2,9,59,160,2,1,163,162,Parisi,
2703,75990002,2M,13,24,6,4,1,10,26,84,1,0,85,86,Parisi,
2717,76942111,111,33,50,18,14,1,11,34,161,1,1,163,164,Kast,
2722,76942010,10,33,44,21,6,3,8,44,159,0,0,159,157,Kast,
2699,70050001,1M-2M-3M,13,51,40,13,1,6,56,180,3,7,190,189,Parisi,
39,75890036,36M,23,47,15,17,2,16,47,167,2,2,171,170,Kast,
1,70071204,204V,24,42,12,3,2,5,4,92,1,0,93,110,Kast,
21,70071238,238V,29,35,3,10,4,10,30,121,0,0,121,120,Kast,
3,70070114,114M,14,28,3,4,0,4,26,79,0,0,79,80,Kast,
4,70071076,76V,36,46,13,8,1,8,21,133,1,0,134,128,Kast,
8,70071032,32V,21,36,8,10,3,7,25,110,0,2,112,114,Kast,
23,70071020,20V,19,43,11,9,0,16,23,121,0,2,123,119,Kast,
17,70070208,208M,37,34,5,9,2,11,23,121,1,0,122,123,Boric,
12,70070004,4M,10,30,9,6,1,6,17,79,2,0,81,82,Kast,
18,70071221,221V,25,44,13,6,0,8,21,117,1,1,119,118,Kast,
49,77152072,72,39,54,13,12,3,5,39,165,0,0,165,164,Kast,
48,77152038,38,35,62,5,17,4,9,9,141,1,0,142,170,Kast,
87,70230082,82M,25,43,18,17,4,13,42,162,4,1,167,162,Kast,
89,70230001,1M-306,17,14,11,7,1,10,30,90,0,0,90,93,Parisi,
90,70232297,297,0,0,0,0,0,0,0,0,0,0,0,126,Boric,
91,70230051,51M,34,34,17,8,3,18,49,163,1,0,164,165,Parisi,
91,70230058,58M,29,29,15,11,1,18,60,163,1,1,165,164,Parisi,
94,70230065,65M,30,37,10,15,0,11,49,152,1,0,153,151,Parisi,
95,70231056,56V,32,20,11,9,4,10,57,143,0,0,143,138,Parisi,- Falla VNU - Falla VBL
102,70230034,34M,24,24,13,8,3,15,64,151,1,0,152,150,Parisi,
114,70251027,27V,36,51,22,11,2,10,38,170,3,0,173,172,Kast,
117,70251163,163V,51,59,14,19,1,4,36,184,1,1,186,189,Kast,
139,70341105,105V,40,32,29,12,1,5,31,150,0,1,151,150,Boric,
140,70341129,129V,40,39,20,14,4,6,33,156,1,1,158,159,Boric,
147,70340009,9M,23,41,30,13,1,10,28,146,0,0,146,145,Kast,
147,70340015,15M,20,35,24,12,1,4,22,118,1,0,119,118,Kast,
150,70340030,30M,25,32,37,9,5,8,13,129,0,0,129,130,Provoste,
150,70342149,149,21,17,8,10,1,5,52,114,0,1,115,114,Parisi,
143,70340073,73M,31,44,33,17,4,7,27,163,0,1,164,163,Kast,
145,70340046,46M,23,28,41,12,1,6,2,113,1,0,114,132,Provoste,
146,70342206,206,34,35,31,9,2,14,26,151,0,1,152,150,Kast,
138,77172001,1,32,31,26,10,16,35,1,151,1,2,154,153,ME-O,
138,77172013,13,38,27,28,11,2,8,47,161,0,0,161,159,Parisi,
155,70371010,10V,24,16,29,2,5,6,47,129,0,3,132,131,Parisi,
166,70430004,4M,11,10,46,2,1,7,15,92,0,1,93,94,Provoste,
166,70431001,1V,10,6,68,3,0,1,17,105,0,0,105,106,Provoste,
163,70400002,2M,12,9,70,11,0,4,29,135,0,2,137,136,Provoste,
156,70380007,7M,13,18,69,10,0,4,7,121,2,1,124,133,Provoste,
157,70380050,50M,0,0,0,0,0,0,0,0,0,0,0,167,Boric,
160,70381049,49V,21,16,56,13,1,4,39,150,1,0,151,152,Provoste,
161,70380034,34M,19,18,58,11,2,2,29,139,1,1,141,142,Provoste,
250,70711002,2V,30,30,35,5,0,3,10,113,1,1,115,116,Provoste,
240,70640036,36M,33,26,18,17,3,13,36,146,0,1,147,148,Parisi,- Falla VNU 
239,70641017,17V,42,25,32,13,1,9,24,146,1,1,148,179,Boric,
237,70640009,9M,32,27,33,10,1,8,31,142,0,2,144,143,Provoste,
246,70670007,7M,35,36,19,19,5,19,19,152,0,1,153,343,Kast,
245,70671009,9V,34,25,22,18,1,21,16,137,3,3,143,142,Boric,
248,70690002,2M,25,20,25,16,1,12,13,112,1,3,116,118,Boric,
243,70651018,18V,32,32,27,10,0,10,55,166,0,1,167,168,Parisi,- Falla VNU 
243,70652031,31,37,20,8,10,2,3,47,127,2,0,129,130,Parisi,
243,70652034,34,44,23,15,8,2,5,34,131,6,0,137,134,Boric,
243,70652035,35,27,19,10,9,3,4,42,114,1,0,115,113,Parisi,
242,70650003,3M,27,27,25,15,3,6,29,132,1,0,133,134,Parisi,
202,70471090,90V,35,38,17,14,0,18,28,150,1,0,151,150,Kast,
202,70471094,94V,38,32,14,15,2,14,20,135,3,1,139,150,Boric,
200,70470071,71M,30,31,22,16,0,10,30,139,1,1,141,142,Kast,
200,70470085,85M,39,35,20,16,1,10,21,142,4,0,146,148,Boric,
200,70470086,86M,40,31,22,22,1,22,21,159,0,6,165,167,Boric,
199,70472164,164,34,19,3,6,0,7,40,109,3,0,112,342,Parisi,- Falla VBL
198,70471117,117V,51,45,14,16,4,14,39,183,2,1,186,185,Boric,
191,70471018,18V,25,36,21,15,1,8,18,124,2,1,127,130,Kast,
187,70461001,1V,26,23,27,7,4,8,14,109,2,3,114,112,Provoste,
186,70440026,26M,29,50,19,21,2,8,7,136,1,0,137,147,Kast,
186,70440042,42M,45,28,25,21,4,0,30,153,1,1,155,168,Boric,
183,70440003,3M,27,45,22,26,0,6,10,136,2,2,140,114,Kast,
183,70440014,14M,31,45,19,31,1,6,12,145,2,0,147,146,Kast,
182,70442181,181,53,41,13,14,5,11,27,164,2,1,167,166,Boric,
182,70442197,197,35,29,5,18,4,12,25,128,1,0,129,130,Boric,
181,70442209,209,42,53,11,20,4,9,18,157,1,0,158,157,Kast,
181,70442221,221,55,37,9,20,4,7,21,153,1,0,154,153,Boric,
178,70441016,16V,36,39,22,19,1,18,19,154,2,0,156,146,Kast,
177,70441127,127V,69,49,23,24,2,15,21,203,1,0,204,205,Boric,
177,70441128,128V,43,48,20,19,3,12,31,176,1,0,177,176,Kast,
176,70440133,133M,40,60,14,35,0,8,30,187,0,1,188,187,Kast,
174,70441095,95V,47,42,21,27,0,1,19,157,0,0,157,161,Boric,- Falla VNU - Falla VBL
173,70441031,31V,32,28,16,22,1,15,19,133,0,0,133,132,Boric,
171,70440082,82M,39,39,20,13,1,5,19,136,0,0,136,138,Boric,
259,76022084,84,30,28,9,3,3,8,46,127,1,0,128,127,Parisi,
257,76020005,5M,43,35,34,14,4,22,34,186,1,1,188,187,Boric,
255,76022108,108,65,42,17,11,5,16,56,212,1,0,213,214,Boric,
209,70520002,2M,28,24,19,22,3,7,15,118,0,1,119,118,Boric,
233,70620008,8M,24,30,30,5,2,6,7,104,5,2,111,120,Kast,
230,70601001,1V,16,26,17,13,0,0,14,86,1,0,87,88,Kast,
230,70601004,4V,24,28,16,14,1,6,20,109,3,0,112,350,Kast,
231,70610002,2M,20,9,17,5,0,10,20,81,0,1,82,81,Boric,
260,76452006,6,24,18,12,7,0,10,35,106,2,0,108,109,Parisi,
227,70581010,10V,17,17,15,9,2,9,17,86,2,2,90,88,Boric,
226,70582025,25,15,13,3,2,1,0,32,66,0,0,66,70,Parisi,- Falla VNU - Falla VBL
229,70591001,1V,16,26,18,10,2,8,3,83,0,2,85,112,Kast,
223,70550004,4M,25,24,32,19,0,23,7,130,3,1,134,171,Provoste,
220,70530004,4M,23,28,14,12,0,9,13,99,0,0,99,100,Kast,
220,70530008,8M,16,34,19,17,3,7,23,119,2,1,122,121,Kast,
220,70530011,11M,20,31,21,18,4,9,15,118,2,1,121,122,Kast,
220,70530020,20M,19,29,29,11,2,10,17,117,3,0,120,121,Kast,
215,70530074,74M,32,28,28,24,0,20,28,160,1,0,161,160,Boric,
215,70530080,80M,40,49,24,20,3,8,0,144,1,0,145,174,Kast,
215,70530092,92M,41,47,30,34,1,18,51,222,1,0,223,212,Parisi,- Falla VBL
215,70531001,1V,22,16,17,6,0,10,16,87,1,0,88,89,Boric,
214,70532141,141,27,14,11,9,1,3,0,65,0,1,66,108,Boric,
214,70532142,142,30,29,9,8,4,7,40,127,1,0,128,129,Parisi,
212,70530059,59M,28,30,19,18,0,10,24,129,0,0,129,130,Kast,
211,70530029,29M,22,35,22,12,2,13,15,121,1,2,124,126,Kast,
211,70530034,34M,31,26,20,15,2,12,28,134,1,0,135,136,Boric,
210,70531033,33V,37,29,28,13,2,4,15,128,2,0,130,129,Boric,- Falla VBL
235,70630008,8M,18,26,22,8,0,10,45,129,0,2,131,130,Parisi,
342,70962027,27,38,42,12,12,4,6,13,127,1,0,128,130,Kast,
343,70961007,7V,39,55,16,16,1,17,21,165,2,0,167,168,Kast,
466,71121015,15V,36,36,19,24,1,9,16,141,0,0,141,140,Boric,
492,71170061,61M,44,24,21,13,3,23,31,159,1,1,161,160,Boric,
492,71170062,62M,34,37,20,13,2,17,26,149,1,4,154,153,Kast,
493,71170064,64M,54,25,18,11,7,14,31,160,2,1,163,164,Boric,
495,71170093,93M,79,30,17,25,9,13,29,202,1,1,204,203,Boric,
440,71092070,70,58,105,25,57,7,6,15,273,4,0,277,272,Kast,
440,71092071,71,50,105,12,53,1,10,16,247,2,0,249,0,Kast,
370,70990063,63M,36,27,17,14,1,19,29,143,1,0,144,143,Boric,
378,70990033,33M,42,28,17,26,2,15,17,147,1,1,149,139,Boric,
352,70970153,153M,70,22,20,13,3,12,17,157,0,0,157,158,Boric,
356,70970075,75M,53,30,10,15,4,19,8,139,1,1,141,140,Boric,
362,70970104,104M,53,28,18,17,2,9,10,137,2,1,140,141,Boric,
362,70970116,116M,44,28,11,13,2,24,14,136,2,0,138,137,Boric,
393,71011032,32V,45,24,15,12,6,9,19,130,3,0,133,134,Boric,
407,71042163,163,43,19,4,7,2,4,31,110,0,0,110,111,Boric,
411,71040063,63M,46,47,12,17,5,19,16,162,2,0,164,162,Kast,
2517,76091002,2V,18,128,22,60,0,5,4,237,1,1,239,247,Kast,
1572,71250050,50M,29,46,15,38,3,11,17,159,1,0,160,159,Kast,
1560,71250004,4M,9,43,16,18,3,27,7,123,2,1,126,120,Kast,
1562,71252125,125,53,29,6,26,0,6,7,127,0,0,127,147,Boric,
1562,71252128,128,31,31,6,21,3,9,20,121,0,1,122,121,Boric,
1566,71251024,24V,44,52,17,23,0,18,18,172,1,4,177,176,Kast,
1566,71251037,37V,35,48,14,20,2,18,0,137,1,0,138,148,Kast,
1568,71252110,110,25,61,16,40,1,14,13,170,0,0,170,172,Kast,
1568,71252116,116,27,53,5,24,1,10,11,131,1,0,132,140,Kast,
1569,71251010,10V,29,49,28,18,2,21,4,151,3,1,155,149,Kast,
2542,76622015,15,33,25,13,6,3,17,40,137,2,0,139,140,Parisi,
1573,71260009,9M,31,38,16,12,1,19,18,135,1,1,137,142,Kast,
1575,71262076,76,51,38,9,20,1,20,20,159,0,0,159,160,Boric,
1580,71262054,54,29,32,9,9,2,11,26,118,0,0,118,117,Kast,- Falla VNU - Falla VBL
2565,76952004,4,43,55,21,34,3,7,19,182,0,2,184,185,Kast,
2566,76962004,4,48,43,26,15,4,19,7,162,1,4,167,344,Boric,
2566,76962011,11,57,39,15,23,5,14,13,166,0,0,166,168,Boric,- Falla VNU - Falla VBL
2342,72092025,25,36,40,8,13,0,9,16,122,1,0,123,120,Kast,
2343,72090013,13M,47,49,21,29,1,9,11,167,1,1,169,168,Kast,
2538,76572043,43,52,14,7,7,4,11,23,118,0,1,119,120,Boric,- Falla VNU 
2284,72071076,76V,53,34,31,16,2,25,10,171,3,0,174,175,Boric,
2301,72070244,244M,44,30,25,31,1,26,11,168,2,1,171,172,Boric,
2301,72070246,246M,48,44,28,31,2,26,9,188,0,2,190,189,Boric,
2302,72070273,273M,51,39,17,33,1,29,9,179,2,1,182,181,Boric,
2286,72072306,306,39,33,11,13,3,20,18,137,0,0,137,127,Boric,
2286,72072318,318,48,17,5,14,2,17,19,122,4,1,127,126,Boric,
2286,72072319,319,30,17,12,14,1,11,21,106,2,0,108,350,Boric,
2287,72072330,330,53,26,12,17,6,18,7,139,0,0,139,140,Boric,
2296,72071181,181V,49,33,15,15,3,17,11,143,0,1,144,143,Boric,
2297,72071203,203V,53,32,17,13,3,16,20,154,4,0,158,160,Boric,
2335,72072375,375,45,30,11,15,1,14,19,135,0,0,135,136,Boric,
2304,72070198,198M,63,29,22,24,2,20,12,172,0,2,174,164,Boric,
2304,72070204,204M,53,28,28,25,4,23,10,171,2,0,173,171,Boric,
2294,72070162,162M,45,30,24,16,3,24,16,158,2,1,161,173,Boric,
2305,72071049,49V,49,25,14,21,4,21,9,143,0,2,145,143,Boric,
2306,72071055,55V,57,33,23,17,3,16,13,162,1,3,166,167,Boric,
2337,72070018,18M,42,24,16,13,3,26,1,125,1,1,127,125,Boric,
2337,72070021,21M,42,22,9,29,3,25,11,141,1,0,142,130,Boric,
2337,72070024,24M,49,23,17,14,3,18,5,129,3,0,132,131,Boric,
2309,72070030,30M,45,28,17,26,0,19,9,144,1,0,145,144,Boric,
2309,72070039,39M,44,30,20,20,2,17,7,140,1,0,141,142,Boric,- Falla VBL
2309,72070046,46M,48,26,18,15,2,15,6,130,2,0,132,133,Boric,
2310,72070048,48M,40,29,19,20,4,23,16,151,1,0,152,150,Boric,
2310,72070056,56M,51,27,23,29,2,10,16,158,4,0,162,168,Boric,
2311,72071104,104V,42,25,15,20,2,19,8,131,2,0,133,132,Boric,
2339,72070228,228M,48,40,12,22,3,19,15,159,0,0,159,160,Boric,
2316,72071208,208V,46,27,2,17,2,10,19,123,1,0,124,125,Boric,
2317,72071228,228V,80,21,25,16,2,16,9,169,0,0,169,170,Boric,
2317,72071230,230V,62,38,13,23,7,13,7,163,1,0,164,165,Boric,
2318,72072612,612,50,13,10,6,2,20,18,119,0,0,119,118,Boric,
2332,72072435,435,54,10,12,9,2,18,20,125,3,0,128,129,Boric,
2319,72071142,142V,66,23,23,12,2,15,12,153,1,2,156,155,Boric,
2321,72070067,67M,40,33,18,19,6,15,12,143,1,2,146,147,Boric,
2321,72070071,71M,55,26,26,26,3,17,13,166,2,0,168,158,Boric,- Falla VBL
2321,72070072,72M,49,29,22,28,1,13,6,148,1,0,149,150,Boric,
2322,72070100,100M,60,21,18,24,3,28,11,165,1,1,167,157,Boric,
2323,72070285,285M,51,29,18,30,0,24,13,165,2,1,168,169,Boric,
2340,72070295,295M,83,37,16,23,2,20,17,198,2,0,200,199,Boric,
2325,72070111,111M,66,31,16,23,2,19,13,170,0,1,171,170,Boric,
2326,72070123,123M,55,43,13,18,1,20,10,160,0,0,160,161,Boric,
2326,72070125,125M,45,29,19,21,3,23,8,148,1,2,151,154,Boric,
2328,72071023,23V,34,30,19,19,2,22,7,133,5,1,139,138,Boric,
2564,76662020,20,81,29,15,15,2,11,13,166,166,1,333,167,Boric,
2345,72100002,2M,43,31,18,21,2,10,9,134,5,0,139,140,Boric,
2345,72100020,20M,92,38,27,24,4,12,20,217,3,1,221,220,Boric,
2346,72101020,20V,71,37,18,21,1,14,12,174,0,1,175,176,Boric,- Falla VNU 
2568,77642005,5,34,48,18,20,4,7,21,152,1,0,153,152,Kast,
2400,72141054,54V,38,76,17,18,0,20,16,185,1,0,186,187,Kast,- Falla VBL
2567,77632010,10,37,38,13,20,2,9,27,146,199,1,346,147,Kast,
2389,72131020,20V,46,55,15,29,1,8,15,169,2,0,171,172,Kast,- Falla VBL
2463,75340011,11M,49,68,19,34,1,11,11,193,2,0,195,194,Kast,
2475,75902006,6,63,47,11,38,3,17,29,208,1,1,210,204,Boric,
2403,72150006,6M,32,47,14,12,4,12,13,134,2,2,138,136,Kast,
2403,72150017,17M,22,51,16,13,1,16,15,134,1,0,135,134,Kast,
2404,72150023,23M,45,45,15,13,1,13,13,145,0,0,145,146,Boric,
2405,72152085,85,50,51,23,13,2,17,17,173,0,0,173,174,Kast,
2408,72151033,33V,51,63,24,7,3,11,25,184,1,1,186,744,Kast,
2349,72111232,232V,73,34,15,14,8,16,20,180,1,0,181,180,Boric,
2368,72111028,28V,26,29,27,12,0,17,15,126,4,2,132,340,Kast,
2368,72111034,34V,39,30,18,13,4,21,15,140,2,1,143,144,Boric,
2368,72111043,43V,45,37,18,10,3,24,12,149,1,4,154,155,Boric,
2364,72111016,16V,29,46,23,16,1,20,4,139,2,1,142,141,Kast,
2366,72111078,78V,40,44,28,14,2,19,16,163,4,6,173,175,Kast,
2371,72110199,199M,66,55,21,20,2,15,7,186,1,0,187,188,Boric,
2382,72111116,116V,35,40,24,2,20,12,2,135,2,0,137,155,Kast,- Falla VBL
2423,72180006,6M,34,24,32,16,0,9,19,134,0,0,134,132,Boric,
2424,72190005,5M,43,63,21,29,0,11,13,180,2,5,187,344,Kast,
2426,72192032,32,54,37,11,13,4,2,28,149,0,0,149,148,Boric,
2429,72202021,21,47,47,13,16,6,11,15,155,3,0,158,157,Boric,
2412,72160096,96M,48,62,16,37,5,0,21,189,0,1,190,204,Kast,
2410,72161073,73V,37,51,19,11,0,16,11,145,1,0,146,145,Kast,
2410,72161090,90V,47,52,14,24,6,9,19,171,0,4,175,174,Kast,
2413,72161093,93V,54,58,22,23,3,13,16,189,0,2,191,192,Kast,
2413,72162107,107,29,30,7,11,0,4,0,81,1,0,82,109,Kast,
2414,72162125,125,34,32,7,17,3,4,23,120,0,0,120,121,Boric,
2416,72162154,154,48,35,4,16,4,6,20,133,1,2,136,134,Boric,
2417,72160017,17M,25,41,27,14,0,8,9,124,0,2,126,131,Kast,
2419,72160043,43M,34,30,17,19,1,15,12,128,4,0,132,130,Boric,
2419,72160046,46M,30,47,22,29,0,9,11,148,2,1,151,152,Kast,
2419,72160062,62M,45,44,9,24,4,11,13,150,2,0,152,162,Boric,- Falla VBL
2420,72160067,67M,31,54,22,23,0,5,14,149,7,0,156,155,Kast,
2421,72161005,5V,30,40,29,17,3,8,7,134,0,0,134,137,Kast,
2421,72161024,24V,35,39,30,16,1,17,10,148,3,1,152,154,Kast,
2422,72161043,43V,32,52,24,15,2,8,16,149,8,0,157,151,Kast,- Falla VBL
2431,72211008,8V,23,43,22,12,1,7,11,119,1,2,122,124,Kast,
1887,71621104,104V,57,51,15,15,4,15,14,171,0,1,172,171,Boric,
1888,71620084,84M,48,39,15,20,3,16,24,165,3,0,168,0,Boric,- Falla VBL
1888,71620088,88M,78,32,3,30,3,19,12,177,3,2,182,188,Boric,
1896,71621014,14V,46,39,19,24,3,2,13,146,2,0,148,158,Boric,
1819,71561011,11V,24,30,20,11,3,24,10,122,0,1,123,124,Kast,
1819,71561014,14V,36,28,25,20,1,25,3,138,2,2,142,148,Boric,
1830,71561079,79V,55,24,17,16,0,14,13,139,1,1,141,350,Boric,
1719,71460085,85M,36,26,14,20,4,15,11,126,1,0,127,128,Boric,
1719,71460086,86M,39,30,19,21,2,9,15,135,1,0,136,137,Boric,
1721,71460044,44M,34,31,24,19,2,16,18,144,1,0,145,144,Boric,
1724,71461043,43V,56,20,13,12,4,10,12,127,0,0,127,117,Boric,
1726,71461054,54V,45,26,19,13,4,11,15,133,4,0,137,138,Boric,
1726,71461066,66V,44,16,18,9,3,20,7,117,1,2,120,125,Boric,
1726,71461068,68V,44,21,9,7,4,20,12,117,1,0,118,120,Boric,
1708,71440088,88M,40,36,11,17,8,19,18,149,1,0,150,149,Boric,
1709,71440079,79M,52,28,21,15,2,15,7,140,1,0,141,139,Boric,
1710,71440061,61M,57,35,20,12,2,10,15,151,0,0,151,143,Boric,
1710,71440063,63M,59,25,16,20,15,19,15,169,1,0,170,160,Boric,
1711,71441022,22V,44,24,22,6,3,18,14,131,1,0,132,133,Boric,- Falla VBL
1711,71441029,29V,46,25,18,17,1,19,7,133,3,0,136,143,Boric,
1712,71441050,50V,57,30,11,13,4,24,17,156,1,0,157,159,Boric,
1713,71441070,70V,43,20,19,11,3,12,10,118,2,0,120,119,Boric,
1714,71441082,82V,42,27,16,13,4,22,16,140,0,2,142,140,Boric,
1716,71440010,10M,36,28,22,9,1,16,12,124,3,1,128,127,Boric,
1716,71440016,16M,31,31,15,23,0,13,17,130,1,3,134,138,Boric,
1717,71440051,51M,39,14,13,13,3,25,15,122,2,0,124,125,Boric,
1718,71441004,4V,32,16,16,11,1,19,5,100,1,0,101,100,Boric,
1944,71711052,52V,28,39,9,8,5,8,10,107,0,0,107,102,Kast,
1944,71711057,57V,41,44,11,8,3,13,11,131,1,1,133,131,Kast,
1948,71710020,20M,40,42,23,20,3,19,12,159,3,0,162,163,Kast,
1949,71711013,13V,45,29,21,20,2,29,0,146,0,0,146,160,Boric,
1928,71690003,3M,29,29,17,12,2,19,8,116,0,1,117,116,Boric,- Falla VNU 
1928,71690022,22M,33,23,19,15,3,21,9,123,0,0,123,124,Boric,
1930,71691012,12V,52,23,23,15,1,20,11,145,0,0,145,146,Boric,
1939,71690060,60M,40,30,22,10,1,24,9,136,1,0,137,138,Boric,
1933,71692134,134,46,18,2,10,3,14,20,113,0,0,113,112,Boric,
1933,71692145,145,45,13,5,10,3,21,3,100,2,0,102,130,Boric,
1941,71690112,112M,54,43,23,14,2,22,23,181,0,6,187,181,Boric,
1941,71690131,131M,57,40,16,22,3,20,24,182,1,0,183,184,Boric,- Falla VBL
1942,71690078,78M,36,26,13,11,3,25,3,117,1,0,118,127,Boric,
1943,71690099,99M,33,43,18,15,3,20,13,145,0,1,146,147,Kast,
1693,71400061,61M,47,38,13,21,2,14,5,140,2,0,142,141,Boric,- Falla VBL
1693,71400071,71M,58,37,12,16,2,10,12,147,3,0,150,0,Boric,- Falla VBL
1693,71400073,73M,44,30,17,14,1,10,9,125,1,0,126,125,Boric,
1693,71400080,80M,52,33,18,22,4,8,10,147,1,0,148,147,Boric,
1700,71420005,5M,31,14,17,11,1,6,4,84,2,0,86,98,Boric,- Falla VBL
1700,71420016,16M,40,33,12,18,0,18,9,130,130,3,263,133,Boric,
1703,71420046,46M,56,21,14,12,5,12,21,141,2,2,145,143,Boric,
1702,71421026,26V,44,26,16,18,4,14,11,133,0,2,135,133,Boric,
1702,71421036,36V,43,18,24,15,2,16,8,126,3,2,131,126,Boric,
1729,71481001,1V,37,9,19,9,4,19,8,105,0,1,106,117,Boric,
1730,71481026,26V,48,35,20,15,5,28,17,168,6,2,176,175,Boric,
1736,71480057,57M,35,38,17,12,0,24,21,147,2,1,150,151,Kast,
2501,76072045,45,48,71,16,67,3,10,8,223,1,0,224,225,Kast,
1649,71340072,72M,65,31,18,22,1,9,15,161,1,1,163,162,Boric,
1650,71340100,100M,60,30,19,20,0,16,3,148,1,0,149,143,Boric,
1651,71340114,114M,71,38,15,21,3,8,9,165,0,10,175,166,Boric,
1651,71342127,127,11,11,2,9,1,1,2,37,1,1,39,37,Boric,
1655,71340038,38M,51,40,11,31,2,12,9,156,1,0,157,0,Boric,
1655,71340048,48M,54,36,12,19,4,10,15,150,0,0,150,151,Boric,
1899,71640018,18M,32,34,15,29,2,17,7,136,0,0,136,163,Kast,
1903,71641034,34V,48,46,12,14,6,14,7,147,1,1,149,150,Boric,
1906,71641051,51V,61,38,24,15,2,17,12,169,2,1,172,176,Boric,
1904,71640096,96M,51,33,12,19,2,13,17,147,0,1,148,149,Boric,
1904,71640099,99M,43,34,8,22,3,14,9,133,0,0,133,0,Boric,
1909,71641101,101V,54,38,17,11,2,15,2,139,0,0,139,148,Boric,
2056,71850037,37M,56,43,14,25,0,10,9,157,1,1,159,160,Boric,
2060,71852266,266,68,35,19,25,2,19,11,179,2,1,182,180,Boric,
2066,71851107,107V,59,56,25,28,3,16,10,197,1,0,198,197,Boric,- Falla VBL
2067,71852237,237,72,32,12,22,5,11,10,164,3,1,168,167,Boric,
2068,71852188,188,66,28,9,22,4,16,24,169,1,0,170,169,Boric,
2058,71851081,81V,69,32,14,26,4,18,19,182,2,1,185,186,Boric,
2058,71851082,82V,57,36,11,24,2,12,11,153,2,0,155,154,Boric,
2059,71851098,98V,54,41,21,17,4,16,11,164,0,1,165,173,Boric,
2089,71870047,47M,57,32,22,19,6,14,11,161,2,0,163,164,Boric,
2099,71870056,56M,41,32,24,17,2,18,3,137,1,1,139,149,Boric,
2099,71870059,59M,52,32,22,19,5,11,14,155,0,4,159,158,Boric,
2100,71870075,75M,62,29,16,22,5,22,12,168,0,0,168,164,Boric,
2100,71870078,78M,36,23,16,35,3,10,11,134,2,0,136,135,Boric,
2091,71872124,124,72,25,5,19,5,16,26,168,1,0,169,171,Boric,
2095,71871013,13V,60,37,31,18,5,13,18,182,2,1,185,187,Boric,
2094,71871086,86V,94,33,17,20,5,31,15,215,2,0,217,207,Boric,
2097,71871034,34V,59,36,22,19,5,16,13,170,1,0,171,168,Boric,
2098,71871060,60V,59,32,29,29,4,12,14,179,0,0,179,180,Boric,- Falla VNU - Falla VBL
2098,71871073,73V,66,44,21,25,1,10,11,178,2,0,180,181,Boric,
2075,71860092,92M,70,49,20,36,3,20,10,208,3,1,212,202,Boric,
2076,71860006,6M,43,44,22,28,1,20,9,167,0,0,167,168,Kast,
2077,71860034,34M,53,29,20,35,3,14,12,166,2,1,169,168,Boric,
2081,71862139,139,64,15,8,22,4,10,9,132,2,0,134,132,Boric,
2088,71861036,36V,53,33,25,27,3,18,11,170,1,0,171,170,Boric,
2083,71862127,127,81,59,24,30,1,18,6,219,2,1,222,221,Boric,
2078,71861008,8V,59,46,25,23,3,16,11,183,1,2,186,180,Boric,
2078,71861013,13V,47,32,28,30,3,16,8,164,1,2,167,187,Boric,
2087,71861074,74V,58,41,13,30,3,16,12,173,0,2,175,178,Boric,
1951,71720121,121M,55,33,24,19,6,29,20,186,0,0,186,187,Boric,
1951,71720135,135M,61,28,24,22,4,23,15,177,1,0,178,179,Boric,
1952,71721054,54V,43,34,28,11,6,23,8,153,1,1,155,153,Boric,
1953,71722154,154,60,22,5,17,3,12,20,139,1,2,142,152,Boric,
1958,71720074,74M,33,36,13,15,1,22,13,133,1,0,134,133,Kast,
1958,71720077,77M,41,35,11,15,2,12,11,127,2,0,129,131,Boric,
1955,71722169,169,72,13,5,11,5,11,21,138,0,1,139,138,Boric,
1956,71721008,8V,25,19,22,14,9,18,11,118,0,0,118,117,Boric,
1962,71720025,25M,37,21,17,15,4,14,7,115,1,1,117,116,Boric,
1963,71721073,73V,50,17,28,12,4,29,9,149,1,0,150,151,Boric,
1965,71721026,26V,44,36,18,10,3,20,17,148,1,0,149,155,Boric,
1966,71721047,47V,42,27,32,16,3,14,2,136,5,2,143,161,Boric,
1968,71720104,104M,54,22,19,9,2,13,18,137,2,0,139,137,Boric,
1974,71741064,64V,40,22,17,1,11,4,0,95,0,0,95,106,Boric,- Falla VNU - Falla VBL
1982,71741024,24V,38,20,16,8,1,21,3,107,3,2,112,114,Boric,
1977,71742236,236,39,17,10,11,3,27,20,127,1,1,129,130,Boric,
1977,71742238,238-247,41,14,5,9,2,9,34,114,7,0,121,120,Boric,
1978,71741003,3V,25,21,27,9,1,13,5,101,0,0,101,103,Provoste,- Falla VNU - Falla VBL
1978,71741009,9V,20,10,25,11,0,19,17,102,1,0,103,102,Provoste,
1972,71741072,72V,25,18,20,12,1,19,13,108,1,1,110,105,Boric,
1975,71740121,121M-152,36,18,17,15,4,19,19,128,1,1,130,132,Boric,
1975,71740128,128M-173,41,19,32,7,5,26,15,145,1,0,146,145,Boric,
1975,71740130,130M,31,33,14,7,5,18,12,120,2,0,122,123,Kast,
1975,71740131,131M,45,27,14,9,4,6,13,118,0,2,120,131,Boric,
1975,71742293,293,26,11,6,2,2,7,11,65,0,0,65,66,Boric,
1976,71742274,274,39,15,4,5,1,6,12,82,1,0,83,82,Boric,
1976,71742281,281,15,20,8,6,1,5,10,65,1,0,66,65,Kast,
1983,71740040,40M,34,20,24,17,0,16,10,121,1,1,123,124,Boric,
2571,77652100,100,37,9,11,12,1,26,21,117,1,0,118,121,Boric,
2571,77652104,104,46,7,7,7,6,15,28,116,0,1,117,116,Boric,
2572,77652128,128,60,22,23,16,8,29,32,190,1,0,191,190,Boric,
2573,77652003,3,25,29,34,19,2,27,8,144,1,1,146,142,Provoste,
2573,77652016,16,39,27,26,22,4,26,15,159,5,1,165,166,Boric,
2573,77652023,23,36,16,27,12,4,22,12,129,0,0,129,130,Boric,
2574,77652031,31,32,25,28,10,0,22,10,127,4,0,131,132,Boric,- Falla VBL
2575,77652073,73,32,16,10,8,2,15,34,117,8,0,125,126,Parisi,
2575,77652075,75,31,17,18,9,2,18,19,114,7,0,121,119,Boric,
2176,71960001,1M,34,49,10,31,0,2,2,128,1,1,130,131,Kast,
2177,71961115,115V,57,67,22,55,0,5,5,211,2,0,213,214,Kast,
2181,71960101,101M,68,71,35,66,2,9,1,252,1,0,253,250,Kast,- Falla VBL
2183,71961046,46V,49,34,27,62,2,9,4,187,0,0,187,207,Sichel,
2184,71961010,10V,35,56,25,33,4,8,4,165,2,0,167,169,Kast,
2233,72020196,196M,45,99,20,89,0,2,7,262,0,0,262,256,Kast,
2233,72020209,209M,33,122,11,68,1,4,1,240,0,0,240,241,Kast,
2234,72020156,156M,28,97,13,86,0,2,2,228,1,0,229,199,Kast,
2237,72021167,167V,28,120,11,88,1,1,1,250,0,0,250,251,Kast,
2253,72022280,280,41,95,18,85,1,3,2,245,2,1,248,249,Kast,
2253,72022281,281,38,106,22,70,0,1,1,238,1,0,239,240,Kast,
2256,72022291,291,47,111,20,96,3,1,4,282,2,0,284,285,Kast,
2256,72022297,297,39,117,35,92,1,4,4,292,2,0,294,282,Kast,
2240,72022256,256,37,91,15,94,1,1,3,242,2,1,245,244,Sichel,
2240,72022263,263,31,60,9,71,4,1,1,177,1,1,179,181,Sichel,
2241,72020149,149M,20,74,21,0,0,4,1,120,0,1,121,168,Kast,- Falla VNU 
2254,72020017,17M,19,88,18,57,1,5,0,188,2,1,191,192,Kast,
2252,72021020,20V,26,111,19,61,0,5,0,222,3,1,226,228,Kast,
2245,72021121,121V,32,105,15,80,0,4,5,241,0,2,243,242,Kast,
2230,72002155,155,37,92,14,62,0,0,0,205,2,1,208,209,Kast,
2220,72001040,40V,36,113,14,74,0,1,1,239,1,0,240,243,Kast,
2280,72061004,4V,19,100,16,54,2,9,4,204,1,2,207,205,Kast,
1916,71661047,47V,41,15,17,7,2,20,18,120,2,2,124,125,Boric,
1913,71661007,7V,36,25,14,11,4,19,29,138,1,0,139,141,Boric,
1913,71661012,12V,51,23,21,14,2,25,14,150,5,2,157,158,Boric,
1917,71660008,8M,31,24,16,13,8,22,18,132,0,2,134,133,Boric,
1919,71671046,46V,48,18,12,11,1,12,20,122,1,0,123,122,Boric,
1919,71671058,58V,60,37,20,12,2,17,13,161,1,0,162,161,Boric,
1919,71671061,61V-90,66,19,16,10,10,13,17,151,1,1,153,151,Boric,
1922,71670006,6M,29,15,12,8,0,6,4,74,0,0,74,88,Boric,
1921,71670027,27M,42,13,11,10,2,13,12,103,2,0,105,104,Boric,
1921,71670037,37M,37,14,13,13,2,17,22,118,1,0,119,118,Boric,
1925,71670070,70M,33,21,20,8,1,13,11,107,1,1,109,108,Boric,
1843,71581106,106V,57,23,22,23,4,19,14,162,0,0,162,161,Boric,
1839,71580015,15M,45,21,13,19,4,16,12,130,2,0,132,133,Boric,
1839,71580018,18M,43,30,16,14,4,26,11,144,3,0,147,148,Boric,- Falla VBL
1848,71582138,138,52,20,4,12,9,9,30,136,1,4,141,140,Boric,
1848,71582148,148,39,22,5,4,5,15,19,109,4,0,113,117,Boric,
1850,71580086,86M,42,21,16,24,2,22,17,144,1,0,145,147,Boric,- Falla VBL
1847,71580042,42M,30,30,31,21,5,19,13,149,149,1,299,150,Provoste,
1847,71580044,44M,40,25,10,23,2,17,9,126,1,2,129,127,Boric,
1838,71580116,116M,50,22,8,28,0,13,10,131,1,0,132,131,Boric,
1838,71580117,117M,51,27,9,22,4,21,23,157,2,1,160,0,Boric,
1838,71580133,133M,83,44,11,28,2,20,10,198,1,0,199,0,Boric,
2526,76192075,75,96,41,21,32,4,13,13,220,2,1,223,225,Boric,
2524,76190002,2M,88,39,22,31,3,13,11,207,0,0,207,206,Boric,
2524,76191001,1V,66,36,22,25,1,11,11,172,0,1,173,172,Boric,
2524,76191004,4V,53,47,13,30,4,9,3,159,0,0,159,160,Boric,
2152,71911082,82V,42,42,8,11,2,9,5,119,1,1,121,122,Boric,
2143,71911007,7V,32,36,11,21,2,12,6,120,2,1,123,122,Kast,
2137,71910004,4M,28,34,12,10,0,13,3,100,0,0,100,110,Kast,
2145,71910098,98M,43,16,14,4,2,9,4,92,1,0,93,108,Boric,- Falla VBL
2145,71910101,101M,38,28,13,28,1,5,5,118,2,0,120,119,Boric,
2146,71910058,58M,57,24,17,21,2,10,18,149,1,1,151,150,Boric,
2151,71910076,76M,42,27,12,21,5,7,10,124,1,0,125,124,Boric,
2509,76080017,17M,75,49,29,35,5,18,9,220,2,0,222,221,Boric,
2508,76082171,171,96,46,25,29,3,19,18,236,4,0,240,230,Boric,
2514,76082051,51,54,42,13,33,2,19,22,185,2,0,187,186,Boric,
2515,76082077,77,56,44,11,20,5,19,27,182,4,0,186,184,Boric,
1851,71601045,45V,67,43,26,21,2,9,0,168,0,1,169,189,Boric,
1854,71600055,55M,56,28,27,22,2,18,10,163,2,0,165,167,Boric,
1859,71601016,16V,37,34,18,20,3,17,8,137,0,2,139,138,Boric,- Falla VNU 
1860,71600032,32M,47,29,17,24,1,21,7,146,1,0,147,146,Boric,
1883,71600045,45M,53,42,15,29,2,17,11,169,0,0,169,170,Boric,
1883,71600048,48M,44,42,22,25,1,21,6,161,0,1,162,161,Boric,- Falla VNU 
1861,71600203,203M,61,39,16,19,3,20,13,171,0,0,171,173,Boric,
1861,71600204,204M,49,30,16,32,1,18,20,166,3,176,345,169,Boric,
1866,71601241,241V,66,38,18,23,5,15,11,176,1,0,177,176,Boric,
1864,71600005,5M,34,41,26,21,3,12,9,146,1,0,147,148,Kast,
1864,71600019,19M,57,39,13,25,1,26,4,165,0,1,166,167,Boric,
1868,71600082,82M,45,30,23,24,2,18,12,154,2,0,156,158,Boric,
1869,71600115,115M,64,37,18,22,3,19,3,166,3,0,169,173,Boric,
1869,71600117,117M,42,46,19,30,4,6,7,154,1,0,155,177,Kast,
1880,71601209,209V,56,39,23,27,2,16,12,175,1,1,177,176,Boric,
1871,71600148,148M,52,43,8,20,4,12,4,143,2,0,145,318,Boric,
1871,71600149,149M,49,33,14,27,3,18,16,160,0,0,160,150,Boric,
1871,71600153,153M,51,38,19,34,4,16,12,174,1,0,175,176,Boric,
1871,71600156,156M,53,40,19,16,8,16,15,167,0,1,168,320,Boric,
1871,71600162,162M,46,52,23,27,2,18,5,173,4,0,177,320,Kast,
1872,71601103,103V,65,30,23,16,3,13,14,164,3,0,167,168,Boric,
1874,71600123,123M,56,33,19,29,0,14,5,156,2,0,158,159,Boric,
1875,71601156,156V,37,42,24,37,4,19,16,179,1,0,180,179,Kast,
1885,71601170,170V,40,40,16,24,2,14,2,138,0,0,138,148,Boric,
1877,71601074,74V,42,40,31,11,0,15,13,152,1,0,153,321,Boric,
2486,75971021,21V,62,46,22,18,24,27,11,210,4,2,216,196,Boric,
2487,75971033,33V,70,32,22,13,2,31,27,197,1,0,198,199,Boric,- Falla VBL
2488,75972213,213,76,18,12,20,2,29,16,173,1,0,174,172,Boric,
2489,75972194,194,64,22,10,6,9,12,20,143,1,0,144,145,Boric,
2494,75970002,2M,49,31,24,32,6,31,16,189,2,1,192,185,Boric,
2494,75970007,7M,55,44,25,24,5,22,22,197,2,0,199,197,Boric,
2496,75970044,44M,73,32,24,29,5,30,16,209,0,2,211,209,Boric,
2498,75972105,105,49,26,9,17,5,12,23,141,0,1,142,145,Boric,
2499,75972108,108,54,17,6,15,2,20,24,138,0,0,138,137,Boric,
2126,71890056,56M,81,61,28,36,0,9,6,221,2,1,224,223,Boric,
2122,71891071,71V,83,45,24,29,2,6,7,196,1,2,199,203,Boric,
2129,71901060,60V,84,55,31,31,5,6,0,212,2,1,215,213,Boric,
2128,71900061,61M,78,52,17,49,3,4,0,203,2,0,205,208,Boric,
2130,71901073,73V,110,54,27,54,9,7,7,268,2,1,271,0,Boric,
2132,71901009,9V,82,53,22,57,2,5,7,228,1,1,230,231,Boric,
2104,71880007,7M,52,46,18,24,2,7,3,152,1,1,154,156,Boric,
2104,71880020,20M,63,59,12,27,4,8,4,177,1,0,178,177,Boric,
2111,71880080,80M,83,54,18,51,3,9,1,219,2,0,221,222,Boric,
2111,71880084,84M,82,41,23,37,1,5,2,191,1,1,193,183,Boric,
2115,71881062,62V,119,37,25,38,5,6,4,234,2,0,236,237,Boric,
2025,71801033,33V,5,30,17,15,4,17,6,94,1,0,95,155,Kast,
2025,71801043,43V,48,28,13,11,6,17,12,135,1,1,137,136,Boric,
2026,71801052,52V,66,9,16,9,3,15,4,122,0,0,122,131,Boric,- Falla VNU - Falla VBL
2026,71801058,58V,56,27,6,15,4,14,9,131,0,0,131,135,Boric,- Falla VNU - Falla VBL
2020,71801011,11V,36,22,20,18,5,26,9,136,3,0,139,140,Boric,
2021,71800062,62M,52,33,13,11,2,12,11,134,2,0,136,137,Boric,
2022,71800012,12M,43,32,14,17,6,24,7,143,1,144,288,144,Boric,
2019,71800053,53M,60,20,14,19,1,16,7,137,0,0,137,138,Boric,
2027,71810076,76M,47,18,15,16,5,17,5,123,1,0,124,125,Boric,
2028,71811004,4V,26,22,14,10,2,15,5,94,3,2,99,100,Boric,
2028,71811005,5V,40,26,14,14,5,19,3,121,0,0,121,122,Boric,
2038,71811024,24V,61,31,15,6,3,27,20,163,0,1,164,165,Boric,- Falla VNU 
2033,71810056,56M,45,14,11,9,2,21,3,105,0,1,106,105,Boric,
2037,71810098,98M,76,15,12,12,5,14,8,142,2,0,144,143,Boric,
2029,71810022,22M,39,17,12,11,0,24,10,113,2,0,115,114,Boric,
2030,71810050,50M,57,22,11,4,0,18,27,139,1,0,140,142,Boric,
2034,71810031,31M,33,19,17,14,2,3,17,105,0,0,105,115,Boric,
2034,71810038,38M,48,20,11,14,2,16,17,128,16,6,150,144,Boric,
2528,76202039,39,38,39,7,20,6,18,17,145,0,0,145,146,Kast,
2528,76202045,45,42,26,13,26,3,21,21,152,1,0,153,152,Boric,
2532,76200006,6M,61,56,23,41,0,16,6,203,1,1,205,204,Boric,
2532,76200011,11M,82,58,16,46,0,7,10,219,0,0,219,114,Boric,
2533,76202067,67,63,29,6,24,5,19,27,173,3,0,176,166,Boric,
2535,76202106,106,64,51,18,44,2,11,6,196,2,2,200,199,Boric,
2155,71930085,85M,33,19,34,18,3,23,2,132,2,0,134,142,Provoste,
2155,71930090,90M,40,30,17,25,3,20,11,146,2,0,148,325,Boric,
2155,71930093,93M,47,33,18,23,5,23,13,162,0,0,162,163,Boric,- Falla VNU - Falla VBL
2156,71930108,108M,66,36,16,16,3,19,16,172,0,0,172,182,Boric,
2160,71930142,142M,54,42,23,22,4,19,12,176,1,0,177,176,Boric,
2161,71931112,112V,44,32,18,17,2,21,10,144,10,5,159,146,Boric,
2163,71931061,61V,49,30,34,18,13,22,13,179,2,0,181,161,Boric,
2164,71931074,74V,41,20,29,21,3,14,16,144,1,0,145,144,Boric,
2169,71950029,29M,56,46,16,32,4,17,12,183,2,0,185,184,Boric,
2170,71951038,38V,56,24,20,24,3,15,14,156,3,0,159,158,Boric,
2170,71951039,39V,64,46,22,37,3,22,3,197,1,1,199,209,Boric,
2214,71982293,293,93,65,26,46,3,1,3,237,0,0,237,236,Boric,
2196,71982276,276,89,65,35,47,1,1,2,240,1,1,242,243,Boric,
2199,71980201,201M,51,55,24,44,1,4,0,179,0,0,179,178,Kast,
2199,71980214,214M,81,73,23,46,1,5,4,233,2,1,236,237,Boric,
2198,71980119,119M,40,76,16,41,1,2,9,185,3,1,189,188,Kast,
2205,71980093,93M,53,68,16,39,0,2,2,180,1,1,182,183,Kast,
2550,76652017,17,95,58,22,53,4,11,14,257,1,1,259,258,Boric,
2550,76652020,20,75,75,27,40,3,10,15,245,0,1,246,244,Boric,
1800,71541090,90V,46,26,27,11,9,26,19,164,1,2,167,152,Boric,
1800,71541102,102V,53,30,10,12,7,21,18,151,2,0,153,151,Boric,
1801,71542190,190,38,23,10,11,4,17,12,115,2,0,117,116,Boric,
1803,71542153,153,53,13,6,11,1,17,16,117,5,1,123,122,Boric,
1815,71542168,168,75,18,8,10,4,13,21,149,1,0,150,151,Boric,- Falla VBL
1805,71541119,119V,54,27,7,14,8,8,18,136,2,0,138,137,Boric,
1816,71542140,140,35,19,7,4,2,19,29,115,0,0,115,113,Boric,
1806,71541020,20V,45,26,20,19,2,23,11,146,1,4,151,152,Boric,
1806,71541028,28V,41,32,24,10,2,23,16,148,1,0,149,148,Boric,
1808,71540050,50M,41,31,12,19,1,26,8,138,1,0,139,136,Boric,
1809,71540101,101M,60,31,10,13,4,23,14,155,1,0,156,157,Boric,
1811,71540004,4M,31,20,20,17,4,17,6,115,1,2,118,119,Boric,
1811,71540006,6M,27,28,17,23,20,2,6,123,0,3,126,124,Kast,
1813,71541055,55V,45,33,12,19,4,21,22,156,1,0,157,163,Boric,
1813,71541059,59V,48,18,13,16,3,22,16,136,0,1,137,136,Boric,
2477,75912069,69,55,36,6,22,9,17,25,170,0,0,170,339,Boric,- Falla VNU - Falla VBL
2477,75912074,74,67,22,9,9,5,22,29,163,1,0,164,163,Boric,
2478,75912079,79,83,25,8,13,1,21,26,177,1,0,178,177,Boric,
2481,75912048,48,47,35,12,13,7,15,18,147,0,2,149,150,Boric,- Falla VNU 
2479,75911001,1V,61,37,20,21,2,17,12,170,0,0,170,172,Boric,
2479,75911008,8V,57,35,30,16,4,17,11,170,3,0,173,175,Boric,
2483,75910028,28M,60,34,23,32,4,25,16,194,0,1,195,194,Boric,
1739,71491066,66V,54,41,18,15,2,13,24,167,45,0,212,172,Boric,- Falla VBL
1739,71491071,71V,62,43,21,23,4,22,26,201,1,1,203,201,Boric,
1738,71490063,63M,46,25,29,16,3,33,16,168,2,0,170,171,Boric,
1738,71490075,75M,56,29,24,28,2,27,23,189,0,0,189,188,Boric,
1740,71492202,202,54,18,12,12,2,12,34,144,0,0,144,141,Boric,- Falla VNU - Falla VBL
1759,71492324,324-325-326,29,6,13,11,0,10,2,71,1,1,73,71,Boric,
1742,71492213,213,69,28,8,16,7,13,24,165,0,0,165,166,Boric,
1742,71492214,214,69,19,4,18,3,24,35,172,1,0,173,172,Boric,
1742,71492221,221,66,17,7,15,6,13,27,151,1,0,152,154,Boric,
1743,71492259,259,69,20,6,16,2,10,22,145,1,1,147,146,Boric,
1744,71492125,125,34,41,17,17,2,15,15,141,1,0,142,141,Kast,
1745,71492140,140,49,32,11,17,3,22,20,154,0,0,154,163,Boric,
1746,71490092,92M,64,33,20,28,3,28,12,188,2,0,190,192,Boric,
1749,71491048,48V,58,49,24,26,3,25,20,205,3,1,209,208,Boric,
1749,71491050,50V,52,49,24,14,3,14,19,175,0,2,177,178,Boric,
1749,71491052,52V,67,40,31,26,3,18,19,204,0,2,206,208,Boric,
1749,71491061,61V,74,36,21,16,2,27,28,204,1,0,205,206,Boric,
1750,71492165,165,47,25,7,8,1,30,20,138,1,0,139,145,Boric,
1751,71490032,32M,41,31,31,18,1,31,18,171,1,1,173,174,Boric,
1752,71490108,108M,67,59,18,17,6,28,21,216,0,2,218,198,Boric,
1753,71491023,23V,43,34,24,19,4,22,12,158,0,0,158,160,Boric,
1757,71491087,87V,63,34,23,17,8,13,28,186,1,2,189,190,Boric,
1758,71492172,172,40,26,8,14,5,17,27,137,137,0,274,137,Boric,
1758,71492180,180,4,27,8,15,6,12,32,104,9,0,113,156,Parisi,
1783,71520139,139M,65,38,13,29,4,25,6,180,0,0,180,179,Boric,- Falla VNU - Falla VBL
1783,71520145,145M,79,35,19,27,6,17,3,186,11,0,197,0,Boric,
1783,71520146,146M,61,33,16,29,3,23,13,178,0,0,178,177,Boric,
1795,71520018,18M,27,29,18,16,2,14,4,110,1,1,112,111,Kast,
1795,71520025,25M,36,35,14,14,3,16,4,122,0,0,122,127,Boric,
1798,71521111,111V,54,29,12,18,4,12,7,136,0,0,136,126,Boric,
1794,71521061,61V,52,36,15,16,2,17,11,149,1,0,150,149,Boric,
1659,71360022,22M,46,21,17,19,4,23,11,141,2,1,144,145,Boric,
1659,71360023,23M,38,33,7,20,1,13,9,121,0,6,127,126,Boric,
1660,71360088,88M,75,36,9,18,4,39,8,189,1,0,190,184,Boric,
1663,71361012,12V,57,34,24,18,2,25,17,177,1,1,179,178,Boric,
1664,71361048,48V,64,33,20,14,2,13,10,156,1,0,157,158,Boric,
1665,71361031,31V,50,40,22,20,2,23,7,164,0,0,164,166,Boric,
1662,71361067,67V,63,30,23,11,7,4,9,147,0,0,147,154,Boric,
1666,71360051,51M,43,33,19,22,2,17,17,153,2,0,155,153,Boric,
1666,71360052,52M,44,28,11,24,5,15,17,144,2,0,146,144,Boric,
1668,71360065,65M,54,32,16,14,5,22,17,160,1,0,161,158,Boric,
1671,71380005,5M,36,31,8,13,4,9,7,108,2,1,111,109,Boric,
1671,71380014,14M,43,29,21,16,7,18,3,137,0,1,138,0,Boric,
1674,71380049,49M,43,38,15,22,1,10,7,136,1,0,137,136,Boric,
1673,71380085,85M,54,41,11,18,4,13,13,154,2,0,156,157,Boric,
1676,71382142,142,59,15,4,18,1,12,9,118,0,0,118,112,Boric,
1679,71380019,19M,63,32,17,16,3,4,2,137,1,1,139,138,Boric,
1679,71380032,32M,36,25,12,20,2,10,10,115,1,1,117,116,Boric,
1779,71501138,138V,67,22,21,13,5,27,24,179,1,1,181,180,Boric,
1765,71501004,4V,37,30,20,9,2,17,8,123,0,1,124,123,Boric,
1766,71500052,52M,36,29,32,18,1,23,18,157,157,2,316,159,Boric,
1767,71502157,157,59,13,8,4,8,13,27,132,0,1,133,123,Boric,
1767,71502164,164,46,19,8,5,2,24,36,140,5,0,145,144,Boric,
1769,71500028,28M,40,36,19,17,3,20,12,147,1,1,149,150,Boric,
1769,71500037,37M,40,23,19,16,1,21,17,137,0,1,138,137,Boric,- Falla VNU 
1770,71500073,73M,44,29,13,8,6,18,14,132,1,1,134,135,Boric,
1771,71500102,102M,40,26,18,8,6,22,21,141,2,0,143,141,Boric,
1774,71501018,18V,33,26,12,10,3,24,17,125,2,1,128,127,Boric,
2043,71830106,106M,55,26,10,17,6,18,23,155,2,0,157,155,Boric,
2039,71830041,41M,37,24,17,12,1,9,10,110,0,1,111,114,Boric,
2039,71830042,42M,46,24,19,19,4,12,12,136,0,0,136,133,Boric,
2039,71830048,48M,44,18,16,22,2,19,13,134,2,0,136,140,Boric,
2039,71830049,49M,55,31,16,13,4,17,14,150,0,1,151,152,Boric,
2044,71831081,81V,61,20,21,12,6,18,16,154,2,1,157,158,Boric,
2051,71830003,3M,33,20,10,7,7,13,6,96,2,0,98,106,Boric,
2051,71830006,6M,49,28,10,19,3,10,4,123,0,1,124,123,Boric,
2051,71830009,9M,35,19,14,2,15,7,1,93,1,2,96,114,Boric,
2051,71830014,14M,56,19,21,14,1,18,6,135,4,1,140,136,Boric,
2003,71782188,188,118,59,12,27,4,10,10,240,0,0,240,239,Boric,
2001,71782172,172,130,30,14,32,3,12,14,235,0,0,235,236,Boric,
2017,71780050,50M,36,37,19,30,2,9,8,141,1,0,142,143,Kast,- Falla VBL
2017,71780056,56M,56,36,17,36,2,16,8,171,1,1,173,172,Boric,
2006,71781070,70V,47,56,13,29,1,15,13,174,0,1,175,174,Kast,
2008,71780111,111M,109,43,18,27,6,4,14,221,2,0,223,183,Boric,
2010,71781001,1V,41,22,10,28,2,3,5,111,2,0,113,111,Boric,
2011,71780108,108M,77,38,23,5,21,5,2,171,2,0,173,201,Boric,- Falla VBL
2018,71780074,74M,58,39,11,24,2,15,2,151,1,1,153,163,Boric,
2014,71780023,23M,35,35,19,29,1,9,6,134,1,0,135,134,Boric,
2014,71780029,29M,41,36,11,22,2,14,9,135,1,0,136,135,Boric,
2016,71781095,95V,87,34,24,26,4,8,11,194,1,1,196,191,Boric,
2016,71781110,110V,102,36,18,29,7,11,12,215,1,1,217,219,Boric,
1986,71761097,97V,46,22,13,19,4,27,13,144,1,2,147,148,Boric,
1986,71761098,98V,46,22,22,16,4,8,9,127,1,0,128,129,Boric,
1988,71760027,27M,43,28,14,17,3,22,9,136,1,0,137,136,Boric,- Falla VBL
1991,71760065,65M,35,31,13,1,20,18,8,126,1,0,127,132,Boric,
1992,71761013,13V,40,29,17,14,2,26,16,144,1,1,146,144,Boric,
1992,71761017,17V,37,23,21,17,6,17,13,134,1,3,138,137,Boric,
1995,71761080,80V,45,16,22,8,4,18,12,125,1,0,126,125,Boric,
1997,71760097,97M,43,18,20,5,4,28,18,136,1,0,137,138,Boric,
1994,71761053,53V,33,37,17,7,2,25,13,134,1,0,135,145,Kast,
1994,71761058,58V,45,22,23,13,6,21,16,146,3,5,154,151,Boric,
2000,71760011,11M,39,29,24,12,2,21,7,134,3,1,138,139,Boric,
2000,71760014,14M,28,29,21,17,3,13,18,129,1,0,130,307,Kast,
1609,71282345,345,126,20,13,15,8,6,5,193,2,2,197,198,Boric,
1612,71281052,52V,28,39,13,15,1,5,2,103,0,0,103,104,Kast,
1591,71282189,189,44,33,6,11,1,7,6,108,0,0,108,98,Boric,
1629,71302174,174,31,33,8,20,3,4,5,104,1,1,106,126,Kast,
1629,71302179,179,126,26,18,26,2,11,12,221,1,0,222,221,Boric,
1630,71302182,182,6,74,3,34,0,0,0,117,0,0,117,116,Kast,
1630,71302191,191,154,38,11,30,5,4,8,250,2,0,252,257,Boric,
1619,71301085,85V,69,49,13,21,4,3,1,160,0,0,160,163,Boric,
1617,71300078,78M,33,23,12,9,3,9,6,95,1,0,96,95,Boric,
1624,71301003,3V,38,30,4,10,1,5,7,95,0,0,95,96,Boric,
1615,71301091,91V,61,56,16,16,5,3,2,159,0,2,161,158,Boric,
1633,71321034,34V,48,32,15,30,2,8,2,137,1,0,138,137,Boric,
1644,71321105,105V,57,41,11,16,6,7,5,143,0,1,144,146,Boric,
1638,71320051,51M,62,25,6,25,3,19,8,148,3,1,152,150,Boric,
2260,72040135,135M,21,133,18,84,1,4,1,262,2,0,264,265,Kast,
2260,72040140,140M,13,134,16,103,1,0,2,269,0,0,269,0,Kast,
2261,72041024,24V,16,138,19,63,0,2,1,239,0,1,240,241,Kast,
2261,72041026,26V,16,136,16,69,0,0,1,238,3,0,241,237,Kast,
2264,72040022,22M,25,94,14,82,0,0,1,216,0,0,216,217,Kast,
2267,72040097,97M,23,130,9,86,1,3,1,253,1,1,255,256,Kast,
2268,72040120,120M,15,132,16,88,0,0,3,254,1,0,255,254,Kast,
2270,72040130,130M,25,135,13,105,0,1,0,279,0,1,280,279,Kast,
2452,72242045,45,63,23,5,7,6,9,26,139,4,0,143,144,Boric,
2453,72241005,5V,41,34,34,13,2,16,13,153,3,2,158,159,Boric,
2460,72252044,44,55,20,9,19,2,11,21,137,1,0,138,139,Boric,
2465,75740027,27M,51,47,28,35,2,24,17,204,0,1,205,204,Boric,
2469,75742082,82,53,40,22,18,3,27,26,189,1,2,192,193,Boric,
2472,75740002,2M,41,37,32,18,1,30,10,169,2,1,172,344,Boric,
2471,75740016,16M,40,53,28,18,2,24,23,188,0,1,189,193,Kast,- Falla VNU 
2467,75742064,64,46,31,12,20,4,22,34,169,0,2,171,172,Boric,
2474,75741018,18V,40,44,22,27,2,20,24,179,1,3,183,182,Kast,
2443,72230077,77M,66,36,26,33,4,18,26,209,5,2,216,217,Boric,
2446,72231029,29V,35,39,32,22,1,31,16,176,2,0,178,177,Kast,
2446,72231045,45V,56,31,22,15,3,23,30,180,1,1,182,183,Boric,
2441,72230013,13M,24,37,19,25,0,19,21,145,1,1,147,148,Kast,
2451,72231072,72V,36,57,22,18,2,19,19,173,2,0,175,174,Kast,
2437,72220049,49M,54,59,24,20,2,16,12,187,2,0,189,188,Kast,
2439,72221004,4V,38,40,22,20,3,17,13,153,0,2,155,151,Kast,
2439,72221011,11V,33,52,33,13,4,21,26,182,2,2,186,193,Kast,
2439,72221017,17V,38,47,35,19,0,23,17,179,3,0,182,186,Kast,
600,72412029,29,56,49,13,26,3,12,33,192,0,1,193,194,Boric,
605,72432016,16,27,21,3,10,0,7,4,72,0,1,73,110,Boric,
606,72431002,2V,36,45,15,17,0,8,20,141,3,1,145,146,Kast,
606,72431010,10V,45,38,24,16,2,11,2,138,2,1,141,162,Boric,
557,72281014,14V,43,41,21,16,0,14,27,162,2,1,165,162,Boric,
558,72280015,15M,44,40,16,20,2,23,21,166,4,0,170,169,Boric,
609,72450006,6M,21,41,24,33,0,9,9,137,1,1,139,138,Kast,
607,72441011,11V,31,35,22,25,2,18,17,150,0,4,154,155,Kast,
564,72310014,14M,41,38,18,28,1,21,22,169,3,1,173,172,Boric,
566,72310028,28M,44,63,15,38,3,17,21,201,2,0,203,201,Kast,
568,72311013,13V,44,50,10,27,2,18,16,167,2,0,169,168,Kast,- Falla VBL
568,72311016,16V,48,44,23,25,1,12,24,177,1,2,180,18,Boric,
568,72311020,20V,28,38,23,23,1,9,40,162,4,0,166,167,Parisi,
586,72351015,15V,30,48,15,16,2,6,20,137,3,1,141,140,Kast,
559,72292031,31,41,37,10,10,3,10,27,138,0,1,139,138,Boric,
560,72290013,13M,37,29,19,17,1,16,23,142,1,1,144,145,Boric,
599,72400004,4M,25,36,29,23,3,16,20,152,1,4,157,156,Kast,
597,72390008,8M,26,30,29,26,3,17,7,138,2,0,140,135,Kast,
597,72390013,13M,19,36,30,11,1,6,20,123,2,0,125,126,Kast,
532,72261200,200V,71,58,15,30,2,21,34,231,0,1,232,231,Boric,
535,72260185,185M,39,38,22,30,1,14,31,175,4,0,179,180,Boric,
536,72261137,137V,37,28,10,17,5,10,23,130,0,0,130,131,Boric,
537,72260106,106M,40,43,16,25,1,17,25,167,1,0,168,167,Kast,
537,72260124,124M,44,46,15,14,0,14,23,156,2,0,158,163,Kast,
539,72260140,140M,40,40,14,19,3,18,23,157,1,2,160,161,Boric,
542,72260036,36M,32,42,15,30,1,21,23,164,2,1,167,166,Kast,
542,72260042,42M,33,34,15,34,0,16,33,165,1,2,168,169,Kast,
549,72260022,22M,33,31,20,22,4,18,18,146,5,0,151,146,Boric,
549,72260027,27M,36,38,15,25,0,18,16,148,0,1,149,150,Kast,
550,72261094,94V,50,42,26,20,2,12,25,177,0,0,177,175,Boric,
554,72261108,108V,44,42,18,26,2,13,19,164,0,1,165,0,Boric,
551,72261056,56V,45,41,16,19,1,18,21,161,4,1,166,165,Boric,
552,72261014,14V,32,53,16,25,2,16,18,162,2,0,164,162,Kast,
553,72260158,158M,50,50,16,35,3,12,3,169,3,0,172,199,Boric,
553,72260166,166M,44,36,19,25,4,20,33,181,3,1,185,184,Boric,
553,72260167,167M,44,43,12,16,2,20,23,160,4,1,165,166,Boric,
663,75352047,47,0,36,5,18,0,0,0,59,1,0,60,144,Kast,
663,75352048,48,26,32,8,19,0,8,39,132,0,0,132,341,Parisi,
663,75352049,49,31,31,4,20,3,14,51,154,0,1,155,154,Parisi,
663,75352059,59,48,29,6,12,2,7,62,166,2,0,168,166,Parisi,
663,75352061,61,26,22,9,6,1,12,46,122,1,0,123,124,Parisi,
667,75350010,10M,42,23,16,17,2,31,18,149,2,0,151,156,Boric,
667,75350021,21M,55,68,6,35,3,19,29,215,1,0,216,215,Kast,
576,72342071,71,43,32,11,12,3,12,23,136,4,1,141,142,Boric,
584,72341029,29V,24,37,36,12,2,16,16,143,1,3,147,146,Kast,
577,72340004,4M,21,40,25,16,0,22,9,133,0,0,133,134,Kast,
580,72342074,74,56,24,13,15,5,13,24,150,0,0,150,148,Boric,
581,72340051,51M,59,51,27,27,5,18,20,207,1,1,209,208,Boric,
582,72341007,7V,33,36,32,20,2,16,15,154,2,0,156,154,Kast,
583,72341038,38V,38,44,11,21,4,13,23,154,11,8,173,166,Kast,
669,75540003,3M,26,26,20,18,3,16,14,123,4,1,128,129,Boric,
672,76222005,5,36,28,6,11,2,11,55,149,1,1,151,152,Parisi,
573,72332034,34,49,55,6,24,3,6,27,170,1,1,172,173,Kast,
574,72331005,5V,32,46,32,19,2,13,25,169,5,0,174,175,Kast,
574,72331011,11V,30,36,30,21,2,13,30,162,4,162,328,166,Kast,
589,72370019,19M,27,45,20,28,1,13,12,146,146,1,293,148,Kast,
593,72371018,18V,27,39,28,23,2,4,9,132,3,2,137,136,Kast,
645,72561009,9V,32,33,26,1,6,13,0,111,0,2,113,139,Kast,
646,72562024,24,73,48,23,29,5,8,31,217,2,0,219,218,Boric,
631,72500010,10M,17,32,13,25,1,14,9,111,0,0,111,110,Kast,
639,72520001,1M,23,26,30,29,2,5,9,124,0,1,125,124,Provoste,- Falla VNU 
629,72491012,12V,35,23,37,23,1,10,26,155,1,2,158,157,Provoste,
641,72540010,10M,24,43,47,23,0,17,11,165,1,2,168,167,Provoste,
673,76230001,1M,19,53,17,23,0,11,16,139,3,3,145,142,Kast,
673,76232004,4,24,42,15,18,1,10,24,134,1,0,135,134,Kast,
611,72460076,76M,48,63,16,34,4,15,33,213,0,2,215,214,Kast,
611,72460077,77M,44,36,12,12,2,17,19,142,0,0,142,152,Boric,
616,72460013,13M,33,48,24,19,2,7,17,150,3,2,155,156,Kast,
616,72460016,16M,30,56,24,26,1,7,18,162,3,1,166,164,Kast,
617,72461012,12V,36,44,22,33,1,9,16,161,2,2,165,166,Kast,
634,72512043,43,37,27,8,12,1,4,25,114,2,0,116,115,Boric,
634,72512045,45,35,38,16,21,4,5,14,133,1,2,136,135,Kast,
635,72511012,12V,14,33,25,24,0,4,15,115,0,0,115,117,Kast,
635,72511019,19V,28,30,28,29,2,12,16,145,1,0,146,145,Kast,
637,72510015,15M,27,43,14,24,2,5,15,130,0,3,133,132,Kast,
637,72510019,19M,29,91,33,27,0,6,7,193,2,0,195,145,Kast,
806,73021002,2V,12,48,13,7,0,3,3,86,1,2,89,90,Kast,
806,73021021,21V,21,54,12,13,1,5,14,120,3,1,124,123,Kast,
812,73050010,10M,31,74,20,19,0,11,8,163,1,1,165,164,Kast,
685,72632176,176,55,30,11,23,1,7,31,158,3,1,162,161,Boric,
689,72632145,145,43,38,9,13,7,6,27,143,0,1,144,140,Boric,
829,77232027,27,20,45,22,18,2,11,24,142,4,1,147,146,Kast,
830,77232006,6,11,46,11,16,2,17,27,130,6,2,138,133,Kast,
710,72711001,1V,18,24,31,22,1,5,11,112,4,0,116,115,Provoste,
710,72711011,11V,35,22,27,16,0,4,17,121,1,0,122,121,Boric,
700,72670035,35M,38,59,23,27,3,29,26,205,1,0,206,205,Kast,
703,72671011,11V,32,36,33,14,1,15,14,145,5,1,151,150,Kast,
701,72671018,18V,25,40,35,13,3,22,24,162,2,1,165,167,Kast,
701,72671036,36V,57,75,22,18,3,5,39,219,0,1,220,221,Kast,
702,72670012,12M,22,47,35,18,1,16,14,153,2,0,155,150,Kast,
824,76692005,5,18,29,29,17,2,12,12,119,1,1,121,123,Kast,
714,72750011,11M,19,58,27,16,2,19,27,168,2,0,170,172,Kast,
699,72662022,22,27,45,20,18,4,10,20,144,1,0,145,153,Kast,
706,72690016,16M,22,48,13,17,1,14,3,118,1,1,120,150,Kast,
707,72691012,12V,23,44,44,13,0,12,15,151,2,1,154,144,Kast,
708,72702006,6,18,20,10,23,1,2,10,84,3,0,87,88,Sichel,
713,72741003,3V,13,49,17,22,0,10,4,115,1,1,117,107,Kast,
780,72931021,21V,34,40,19,14,4,10,24,145,0,2,147,146,Kast,
781,72931009,9V,25,31,24,9,1,18,16,124,3,1,128,129,Kast,
765,72911082,82V,25,50,20,23,0,13,17,148,4,1,153,154,Kast,
766,72911034,34V,45,47,22,19,0,14,8,155,1,0,156,157,Kast,
769,72912124,124,43,55,13,15,1,9,22,158,3,1,162,163,Kast,
769,72912127,127,38,38,11,7,1,9,24,128,0,1,129,128,Boric,
773,72910050,50M,24,54,17,25,1,6,17,144,1,1,146,151,Kast,
773,72910055,55M,28,56,10,19,0,11,12,136,0,1,137,55,Kast,- Falla VNU 
775,72911013,13V,27,50,26,17,1,14,7,142,1,4,147,155,Kast,
775,72911017,17V,20,51,31,28,0,9,15,154,2,0,156,157,Kast,
782,72941030,30V,22,60,19,15,1,4,17,138,4,4,146,143,Kast,
784,72941015,15V,15,43,17,19,0,7,9,110,2,0,112,113,Kast,
791,72960002,2M,13,37,11,20,0,16,4,101,2,2,105,95,Kast,
797,72992057,57,36,55,19,14,2,8,33,167,0,1,168,167,Kast,
795,72980017,17M,29,58,26,24,1,14,17,169,0,1,170,171,Kast,
796,72981006,6V,17,36,40,14,1,6,23,137,2,2,141,140,Provoste,
776,72921012,12V,18,46,24,14,3,9,17,131,0,0,131,130,Kast,
776,72921016,16V,19,34,21,15,2,10,14,115,3,0,118,119,Kast,
776,72921019,19V,32,44,21,14,3,6,18,138,4,0,142,143,Kast,
776,72921020,20V,19,56,20,10,1,11,20,137,3,0,140,142,Kast,
777,72921002,2V,15,36,31,12,3,10,7,114,3,0,117,116,Kast,
759,72860009,9M,11,38,26,21,1,12,38,147,2,0,149,150,Kast,
757,72860035,35M,34,42,23,22,3,12,37,173,2,0,175,176,Kast,
758,72861011,11V,25,29,22,16,4,10,24,130,2,0,132,133,Kast,
752,72830001,1M,10,51,18,10,0,14,10,113,0,0,113,116,Kast,
752,72831005,5V,6,74,15,12,0,8,21,136,0,0,136,139,Kast,
752,72831008,8V-9,17,63,15,8,0,5,21,129,1,0,130,131,Kast,- Falla VBL
822,76672001,1,15,39,43,18,1,22,17,155,8,1,164,167,Provoste,
822,76672003,3,18,35,18,21,2,10,11,115,2,1,118,119,Kast,
822,76672010,10,12,22,12,7,1,8,6,68,0,0,68,69,Kast,
750,72821012,12V,24,48,30,16,1,6,33,158,3,2,163,164,Kast,
753,72840011,11M,18,71,38,28,0,10,18,183,1,0,184,185,Kast,
753,72841002,2V,14,43,35,12,0,6,14,124,124,3,251,127,Kast,
753,72841005,5V,21,46,21,25,1,4,15,133,1,1,135,142,Kast,
743,72810034,34M,35,55,22,14,2,7,1,136,0,1,137,162,Kast,
743,72810035,35M,32,49,24,17,11,15,4,152,4,4,160,156,Kast,
744,72810028,28M,33,54,23,25,1,11,20,167,3,1,171,170,Kast,
744,72810029,29M,25,36,30,22,1,6,2,122,2,0,124,144,Kast,
745,72812061,61,30,27,20,14,0,10,23,124,2,2,128,129,Boric,
746,72811001,1V,26,24,20,10,2,5,15,102,2,0,104,105,Boric,
746,72811003,3V,20,35,23,10,0,12,12,112,0,0,112,113,Kast,
746,72811019,19V,18,32,31,12,2,7,16,118,0,0,118,124,Kast,
747,72810009,9M,21,35,26,14,0,14,10,120,0,1,121,122,Kast,
718,72760080,80M,42,53,19,24,6,11,17,172,1,0,173,167,Kast,
720,72761103,103V,43,47,20,24,3,12,21,170,2,2,174,103,Kast,
721,72762290,290,54,31,13,17,1,10,31,157,1,0,158,159,Boric,
721,72762299,299,47,25,7,21,3,8,34,145,0,0,145,149,Boric,- Falla VNU - Falla VBL
721,72762306,306,66,31,4,12,5,6,20,144,3,1,148,151,Boric,
723,72760019,19M,33,45,39,27,0,6,9,159,2,0,161,163,Kast,
725,72762238,238,46,39,5,10,2,5,40,147,0,1,148,147,Boric,
727,72762218,218,30,27,3,15,1,8,45,129,0,0,129,128,Parisi,
728,72760171,171M,45,53,18,34,2,18,28,198,2,0,200,198,Kast,
731,72761129,129V,40,52,32,14,1,8,33,180,2,1,183,182,Kast,
732,72760046,46M,23,39,23,23,20,21,0,149,0,0,149,150,Kast,- Falla VNU - Falla VBL
732,72760052,52M,37,55,19,30,2,12,21,176,1,0,177,176,Kast,
732,72760061,61M,37,62,25,22,3,12,18,179,2,2,183,184,Kast,
733,72761033,33V,30,29,26,24,0,8,19,136,5,0,141,151,Boric,
733,72761035,35V,39,47,28,14,2,25,4,159,1,1,161,171,Kast,
736,72761022,22V,38,31,30,25,4,12,17,157,3,1,161,160,Boric,
737,72760106,106M,26,50,13,27,1,14,18,149,1,0,150,152,Kast,
2778,73220004,4M,18,40,16,19,1,2,11,107,1,1,109,110,Kast,
2778,73221024,24V,25,55,12,19,1,8,16,136,31,3,170,142,Kast,
2779,73221008,8V,14,32,31,19,1,7,14,118,3,4,125,124,Kast,
2779,73221020,20V,17,36,21,25,1,3,11,114,3,3,120,0,Kast,
2780,73220006,6M,14,50,22,22,1,6,10,125,1,1,127,117,Kast,
2780,73220020,20M,18,57,23,24,1,7,18,148,1,0,149,148,Kast,
2802,75951003,3V,25,41,14,15,1,5,24,125,3,1,129,128,Kast,
2727,73071091,91V,25,54,17,14,3,9,15,137,2,0,139,142,Kast,
2728,73070163,163M,25,63,14,24,1,10,20,157,0,0,157,158,Kast,
2730,73070067,67M,24,54,14,27,1,9,14,143,0,2,145,147,Kast,
2730,73070072,72M,25,54,24,22,1,5,18,149,3,1,153,154,Kast,
2731,73071079,79V,35,57,22,18,1,8,16,157,2,0,159,160,Kast,
2731,73071081,81V,33,59,23,19,1,10,20,165,1,2,168,169,Kast,
2731,73071087,87V,27,60,29,17,1,12,16,162,1,1,164,165,Kast,
2733,73070059,59M,23,43,19,29,0,11,18,143,1,0,144,145,Kast,
2733,73070065,65M,27,59,24,27,0,9,15,161,0,2,163,162,Kast,
2734,73070037,37M,29,50,16,27,0,6,12,140,0,0,140,142,Kast,
2734,73070044,44M,24,48,28,21,2,6,20,149,0,0,149,151,Kast,
2735,73070171,171M,30,69,20,28,2,7,22,178,1,0,179,180,Kast,
2736,73072241,241,32,55,19,23,1,5,15,150,0,4,154,151,Kast,- Falla VNU 
2738,73071141,141V,29,67,21,18,3,9,29,176,0,0,176,179,Kast,- Falla VNU - Falla VBL
2739,73071161,161V,38,69,16,29,5,7,25,189,2,2,193,194,Kast,
2740,73071149,149V,40,68,22,18,2,7,29,186,1,0,187,190,Kast,
2740,73071156,156V,45,66,21,18,3,13,20,186,0,1,187,188,Kast,
2742,73070096,96M,27,60,21,15,0,5,21,149,2,0,151,156,Kast,- Falla VBL
2742,73070098,98M,28,60,25,25,1,10,15,164,5,0,169,166,Kast,
2743,73071032,32V,36,66,21,23,3,9,16,174,174,1,349,175,Kast,
2743,73071036,36V,27,49,24,23,1,5,21,150,0,1,151,152,Kast,
2744,73070114,114M,32,28,23,26,0,6,20,135,0,2,137,138,Boric,
2747,73071065,65V,28,62,26,19,1,9,21,166,0,1,167,166,Kast,
2748,73070009,9M,24,38,21,28,4,11,8,134,1,1,136,135,Kast,
2797,75750004,4M,18,44,22,24,0,20,15,143,2,2,147,148,Kast,
2797,75750016,16M,26,60,31,16,0,18,20,171,2,0,173,174,Kast,
2797,75750019,19M,26,58,24,28,1,17,25,179,2,1,182,181,Kast,
2797,75750020,20M,32,58,19,25,1,20,17,172,1,0,173,172,Kast,
2797,75750023,23M,36,61,25,26,1,21,25,195,1,0,196,195,Kast,
2799,75752037,37,12,53,14,14,2,3,29,127,2,1,130,140,Kast,
2772,73191007,7V,16,61,23,15,0,7,17,139,1,0,140,141,Kast,
2773,73190012,12M,13,70,28,20,0,2,17,150,0,2,152,151,Kast,
2773,73190015,15M,21,61,22,25,0,9,9,147,3,0,150,149,Kast,
2777,73211007,7V,9,33,19,5,2,8,12,88,3,0,91,89,Kast,
2767,73161002,2V,8,76,13,17,1,6,17,138,1,0,139,343,Kast,
2767,73161009,9V,18,85,15,13,0,3,20,154,3,2,159,158,Kast,
2767,73161011,11V,17,82,14,20,1,7,2,143,1,0,144,163,Kast,
2784,73241002,2V,11,27,18,14,1,4,14,89,1,1,91,92,Kast,
2782,73230009,9M,12,54,19,25,2,4,24,140,1,1,142,141,Kast,
2782,73230016,16M,19,75,31,19,1,13,21,179,2,1,182,172,Kast,
2782,73230017,17M,27,61,19,21,1,9,31,169,0,0,169,168,Kast,
2774,73201014,14V,31,41,24,6,1,8,21,132,2,3,137,138,Kast,
2808,77292002,2,22,60,22,33,1,10,10,158,1,4,163,165,Kast,
2789,73271019,19V,16,48,14,7,0,8,25,118,1,0,119,115,Kast,
2795,73310001,1M,10,44,31,15,0,4,4,108,3,0,111,112,Kast,
2794,73301017,17V,21,44,34,24,0,5,30,158,3,5,166,165,Kast,
2794,73301020,20V,25,45,26,13,1,6,23,139,3,2,144,143,Kast,
2785,73250002,2M,14,58,28,17,0,11,15,143,0,2,145,146,Kast,
2760,73111005,5V,8,31,9,9,0,4,12,73,1,2,76,75,Kast,
2752,73100033,33M,12,49,18,26,1,8,9,123,1,3,127,126,Kast,
2752,73100041,41M,19,56,20,12,1,10,18,136,1,1,138,137,Kast,
2753,73100057,57M,27,81,17,28,2,7,22,184,0,2,186,187,Kast,
2758,73100014,14M,20,45,17,15,1,5,12,115,4,2,121,122,Kast,
2759,73101015,15V,0,0,0,0,0,0,0,0,0,0,0,118,Boric,- Falla VNU - Falla VBL
2759,73101017,17V,24,64,19,13,1,9,9,139,2,1,142,14,Kast,
2796,73320001,1M,9,44,34,17,2,11,11,128,2,1,131,130,Kast,
2796,73320002,2M,12,29,32,14,2,11,11,111,4,3,118,119,Provoste,
1056,73791026,26V,25,79,16,6,2,4,10,142,1,2,145,153,Kast,
1046,73770007,7M,13,43,22,10,0,11,20,119,2,0,121,122,Kast,
1048,73770031,31M,23,45,48,18,1,14,31,180,0,2,182,152,Provoste,
1048,73771005,5V,16,31,32,11,0,5,12,107,0,3,110,120,Provoste,
1037,73741023,23V,19,52,16,8,1,8,17,121,1,0,122,123,Kast,
1037,73741028,28V,37,63,8,1,1,5,34,149,0,0,149,151,Kast,
1037,73742033,33,20,46,3,1,0,4,24,98,1,0,99,98,Kast,
1088,77052001,1,17,56,28,4,1,15,37,158,4,11,173,171,Kast,
1049,73781008,8V,20,48,30,8,0,7,22,135,1,1,137,139,Kast,
1049,73781014,14V,30,55,16,13,3,9,19,145,0,1,146,145,Kast,
1051,73780002,2M,13,54,24,11,0,11,19,132,0,0,132,131,Kast,
1051,73780006,6M,16,46,18,6,1,5,20,112,4,0,116,119,Kast,
1051,73780007,7M,17,63,18,5,2,9,21,135,2,3,140,320,Kast,
1013,73630004,4M,27,43,21,6,1,12,8,118,0,6,124,123,Kast,
1013,73631001,1V-10,21,38,21,10,11,7,16,124,10,5,139,130,Kast,
1013,73631006,6V,28,38,24,9,1,8,14,122,4,4,130,128,Kast,
1091,77262005,5,34,12,20,5,1,6,22,100,3,6,109,110,Boric,
1008,73601002,2V,20,37,18,13,0,5,29,122,4,1,127,128,Kast,
1027,73681010,10V,17,46,15,15,1,8,38,140,4,0,144,147,Kast,
975,73542220,220,23,62,11,22,2,9,41,170,1,0,171,170,Kast,
979,73542225,225,28,49,14,21,3,2,28,145,0,0,145,144,Kast,
979,73542229,229,18,32,2,9,0,4,23,88,1,0,89,90,Kast,
980,73541141,141V,8,72,9,19,1,6,14,129,3,2,134,133,Kast,
983,73540027,27M,16,68,26,27,41,4,6,188,0,3,191,151,Kast,
984,73540050,50M,9,41,11,18,1,7,17,104,2,0,106,107,Kast,
986,73540114,114M,17,68,17,18,4,11,20,155,0,3,158,159,Kast,
987,73541051,51V,19,56,14,16,0,2,1,108,4,1,113,122,Kast,
996,73540157,157M,28,78,12,30,0,8,20,176,0,0,176,177,Kast,
990,73540006,6M,6,44,12,17,1,5,9,94,2,1,97,96,Kast,
990,73540010,10M,7,48,11,15,0,7,13,101,0,0,101,102,Kast,
990,73540013,13M,12,50,8,12,0,6,12,100,2,1,103,107,Kast,
993,73541070,70V,28,46,16,17,7,5,16,135,0,1,136,130,Kast,
993,73541072,72V,20,51,17,12,1,7,17,125,0,0,125,127,Kast,
993,73541079,79V,22,69,18,14,2,6,30,161,3,0,164,165,Kast,
993,73541082,82V,18,61,14,16,0,6,11,126,0,1,127,128,Kast,
993,73541087,87V,18,63,14,24,1,11,27,158,0,0,158,157,Kast,
993,73541091,91V,11,56,12,14,1,4,22,120,1,0,121,122,Kast,
994,73541017,17V,16,58,19,16,1,4,11,125,2,0,127,126,Kast,
995,73540087,87M,20,54,9,15,0,5,15,118,1,0,119,117,Kast,- Falla VBL
1096,77502034,34,12,27,2,10,1,3,37,92,0,0,92,93,Parisi,
1020,73670024,24M,25,51,18,18,1,6,77,196,2,1,199,177,Parisi,
1020,73671001,1V,14,40,23,8,2,5,2,94,0,2,96,119,Kast,
1022,73671014,14V,15,49,18,14,1,7,44,148,3,1,152,151,Kast,
1019,73661002,2V,12,38,23,15,2,11,20,121,7,5,133,128,Kast,
1019,73662014,14,13,48,8,11,0,4,18,102,1,0,103,102,Kast,
1009,73611012,12V,17,47,23,9,1,8,23,128,0,2,130,129,Kast,
1010,73620011,11M,19,55,16,25,1,3,22,141,1,0,142,141,Kast,
1012,73621018,18V,25,62,18,20,1,10,28,164,1,0,165,164,Kast,
1084,76592002,2-3,26,33,23,22,2,9,13,128,1,1,130,133,Kast,
1031,73700003,3M,16,45,16,8,1,10,10,106,1,0,107,116,Kast,
857,73350026,26M,38,43,22,13,4,13,22,155,0,0,155,156,Kast,- Falla VNU 
858,73351025,25V,40,31,23,19,3,3,10,129,3,2,134,139,Boric,
858,73351032,32V,35,36,14,13,1,6,23,128,6,0,134,135,Kast,
858,73351035,35V,40,48,17,15,1,5,20,146,1,0,147,148,Kast,
860,73351059,59V,39,4,2,9,4,7,22,87,0,0,87,152,Boric,
861,73351008,8V,33,50,29,20,3,9,21,165,2,0,167,168,Kast,
862,73350049,49M,31,28,19,21,0,14,15,128,1,0,129,130,Boric,
863,73351044,44V,34,38,17,15,2,9,17,132,2,0,134,131,Kast,
865,73350057,57M,51,63,18,26,1,14,38,211,2,1,214,204,Kast,
834,73330078,78M,38,47,10,23,0,11,18,147,2,0,149,150,Kast,
844,73331084,84V,40,53,23,27,1,12,18,174,0,0,174,175,Kast,
846,73331122,122V,28,42,20,18,0,8,25,141,1,0,142,148,Kast,
848,73331162,162V,43,54,11,15,3,10,18,154,8,0,162,161,Kast,
849,73330047,47M,24,52,17,22,1,8,10,134,0,2,136,135,Kast,
851,73331150,150V,36,39,10,14,6,8,36,149,1,1,151,152,Kast,
853,73330181,181M,57,58,21,35,2,9,25,207,1,0,208,209,Kast,
963,73520060,60M,20,27,17,6,2,11,12,95,1,1,97,0,Kast,
966,73520026,26M,15,30,24,13,2,9,19,112,3,2,117,116,Kast,
966,73520037,37M,19,30,14,9,1,9,28,110,0,1,111,110,Kast,
971,73521078,78V,29,33,10,6,1,13,27,119,0,0,119,114,Kast,
1071,76262053,53,44,42,7,10,1,12,36,152,0,1,153,152,Boric,- Falla VNU 
1072,76260002,2M,46,38,25,19,5,29,31,193,3,0,196,197,Boric,
1072,76262010,10,33,39,7,9,5,15,50,158,2,0,160,157,Parisi,
1073,76262039,39,23,53,16,16,3,8,52,171,0,0,171,2,Kast,
1074,76262013,13,52,37,12,14,5,6,44,170,1,0,171,172,Boric,
1074,76262019,19,47,27,6,4,2,10,44,140,2,0,142,141,Boric,
1074,76262026,26,37,59,18,12,6,17,43,192,1,0,193,186,Kast,
911,73410098,98M,38,48,18,19,1,24,43,191,1,0,192,191,Kast,
917,73411068,68V,43,39,22,14,1,14,42,175,2,0,177,181,Boric,
918,73411018,18V,33,46,13,21,1,15,37,166,0,0,166,167,Kast,
942,73480017,17M,28,45,18,11,3,14,20,139,1,2,142,152,Kast,
943,73481010,10V,20,45,16,15,5,11,35,147,2,1,150,149,Kast,
945,73481023,23V,38,37,16,8,13,16,33,161,0,1,162,152,Boric,
950,73510031,31M,30,33,19,11,14,40,3,150,0,0,150,151,ME-O,
953,73510043,43M,29,39,19,14,1,10,31,143,1,1,145,146,Kast,
954,73510001,1M,24,33,16,14,0,9,10,106,3,0,109,108,Kast,
954,73510005,5M,23,44,24,6,0,15,18,130,5,1,136,127,Kast,
954,73510012,12M,22,44,14,8,1,17,23,129,3,1,133,130,Kast,
957,73511055,55V,26,45,13,2,3,7,45,141,1,2,144,145,Kast,
951,73511044,44V,46,40,23,4,2,12,29,156,1,2,159,160,Boric,
958,73511025,25V,29,32,22,7,4,14,28,136,3,2,141,144,Kast,
958,73511029,29V,30,52,19,8,1,15,29,154,2,1,157,156,Kast,
923,73431043,43V,34,44,19,14,0,12,38,161,2,1,164,165,Kast,
928,73431006,6V,30,36,35,17,0,7,25,150,2,2,154,0,Kast,
929,73430037,37M,38,43,31,15,6,21,35,189,0,1,190,187,Kast,
1077,76272028,28,43,61,7,19,1,9,45,185,2,0,187,189,Kast,
867,73372151,151,43,60,5,25,7,12,25,177,1,0,178,188,Kast,
868,73372118,118,41,23,9,33,5,7,28,146,4,0,150,152,Boric,
873,73370026,26M,20,46,18,17,0,8,22,131,1,3,135,137,Kast,
877,73370058,58M,40,59,13,27,1,10,18,168,1,1,170,174,Kast,
949,73500012,12M,29,54,18,14,0,16,34,165,1,0,166,167,Kast,
949,73500016,16M,24,63,16,22,2,12,67,206,4,0,210,170,Parisi,
894,73390117,117M,29,31,13,23,6,12,28,142,2,1,145,146,Kast,
904,73391025,25V,28,42,23,14,3,14,28,152,2,0,154,152,Kast,
906,73390093,93M,26,42,17,19,4,12,33,153,2,0,155,156,Kast,
908,73391069,69V,31,45,14,17,1,12,35,155,3,1,159,301,Kast,
908,73391076,76V,32,39,18,5,1,6,3,104,3,0,107,134,Kast,
935,73441010,10V,24,41,25,22,1,11,17,141,1,0,142,141,Kast,
930,73441066,66V,40,55,8,14,3,7,29,156,0,0,156,153,Kast,
934,73441050,50V,30,36,11,4,1,7,39,128,0,11,139,130,Parisi,
1249,74200023,23M,21,63,44,23,1,12,18,182,3,2,187,186,Kast,
1252,74210004,4M,5,75,13,24,0,4,2,123,0,1,124,125,Kast,
1260,74231009,9V,22,51,25,15,3,22,23,161,8,5,174,164,Kast,
1207,74070003,3M,20,47,6,10,1,6,9,99,3,3,105,104,Kast,
1225,74100016,16M,14,53,16,11,0,9,18,121,3,0,124,114,Kast,
1225,74100023,23M,20,72,27,13,0,7,16,155,1,1,157,471,Kast,
1226,74101017,17V,10,42,20,9,2,8,10,101,5,4,110,109,Kast,
1228,74101021,21V,18,69,32,15,4,3,18,159,4,0,163,162,Kast,
1228,74101022,22V,22,50,21,9,1,12,11,126,1,2,129,130,Kast,
1266,75570003,3M,14,39,20,10,1,7,10,101,1,2,104,106,Kast,
1261,74241007,7V,37,47,30,11,2,14,8,149,1,0,150,152,Kast,
1262,74240007,7M,22,44,24,12,2,7,10,121,1,1,123,121,Kast,
1234,74130007,7M,16,67,9,14,1,6,10,123,1,3,127,126,Kast,
1192,74001031,31V,21,66,11,7,1,8,28,142,0,3,145,144,Kast,
1205,74061006,6V,12,36,15,13,1,4,10,91,3,0,94,95,Kast,
1254,74220037,37M,27,44,42,14,3,13,19,162,3,2,167,166,Kast,
1256,74221030,30V,26,48,23,10,3,16,11,137,5,1,143,144,Kast,
1257,74221013,13V,22,51,24,10,0,12,21,140,1,2,143,144,Kast,
1258,74220019,19M,19,55,33,9,0,9,17,142,2,2,146,142,Kast,
1176,73992061,61,15,35,6,9,2,6,38,111,1,0,112,102,Parisi,
1178,73991048,48V,32,78,14,9,1,7,28,169,0,0,169,170,Kast,- Falla VNU - Falla VBL
1187,73992097,97,33,70,12,11,2,7,27,162,2,0,164,165,Kast,
1195,74010001,1M,13,50,16,9,0,8,15,111,4,2,117,118,Kast,
1196,74011010,10V,21,66,20,11,4,9,22,153,5,1,159,157,Kast,
1232,74111021,21V,31,76,18,18,1,14,17,175,1,1,177,176,Kast,
1210,74081003,3V,13,37,16,7,2,6,7,88,1,1,90,88,Kast,
1211,74080013,13M,22,49,27,22,0,8,15,143,1,1,145,144,Kast,
1158,73972162,162,30,44,8,13,1,5,12,113,1,0,114,115,Kast,
1162,73970103,103M,27,52,15,30,0,9,8,141,0,0,141,142,Kast,
1163,73972171,171,25,23,5,12,0,5,19,89,2,0,91,90,Boric,
1164,73970031,31M,19,52,10,3,0,5,3,92,1,0,93,102,Kast,
1166,73970003,3M,16,45,7,13,1,0,5,87,0,0,87,89,Kast,- Falla VNU - Falla VBL
1166,73970012,12M,31,44,21,19,1,7,2,125,1,1,127,126,Kast,
1166,73970020,20M,19,41,13,25,0,3,6,107,1,1,109,107,Kast,
1167,73970052,52M,28,32,17,13,0,8,3,101,1,0,102,122,Kast,
1171,73971062,62V,23,57,9,16,1,5,13,124,2,0,126,124,Kast,
1148,73951030,30V-76V,18,67,16,25,0,15,22,163,0,0,163,164,Kast,
1148,73951039,39V,14,25,6,10,2,8,17,82,2,0,84,83,Kast,
1151,73950107,107M,27,36,8,14,2,3,15,105,0,0,105,104,Kast,
1152,73950075,75M-128M,34,43,18,15,1,13,34,158,3,0,161,162,Kast,
1152,73950076,76M,15,29,10,6,1,4,15,80,1,0,81,80,Kast,
1152,73950080,80M,21,39,8,11,0,6,17,102,0,0,102,188,Kast,
1152,73950087,87M,18,40,18,9,1,9,13,108,0,2,110,111,Kast,
1154,73951067,67V,13,31,9,4,3,7,10,77,1,0,78,79,Kast,
1154,73951077,77V-89V,32,53,12,17,3,15,36,168,1,1,170,169,Kast,
1292,77332039,39,32,58,26,23,2,12,17,170,4,0,174,175,Kast,
1267,75581008,8V,14,48,15,14,0,6,12,109,0,0,109,108,Kast,
1269,75691005,5V,65,87,14,13,3,9,12,203,2,1,206,204,Kast,
1215,74090048,48M,35,69,17,28,1,10,24,184,0,0,184,189,Kast,
1216,74092063,63,34,45,4,30,2,5,32,152,0,0,152,131,Kast,
1219,74091045,45V,30,15,15,17,1,4,26,108,4,2,114,174,Boric,
1220,74090003,3M,16,48,24,16,2,10,4,120,1,0,121,111,Kast,
1220,74090005,5M,23,40,14,13,2,3,3,98,2,0,100,104,Kast,
1220,74090007,7M,12,50,20,14,1,9,7,113,3,1,117,118,Kast,
1221,74091030,30V,18,66,20,13,1,6,9,133,1,2,136,135,Kast,
1223,74090013,13M,18,51,17,21,0,7,0,114,0,2,116,128,Kast,
1223,74090029,29M,17,66,13,21,13,8,15,153,0,2,155,145,Kast,
1104,73821037,37V,31,62,11,21,0,5,21,151,1,0,152,145,Kast,- Falla VBL
1108,73821012,12V,17,68,25,13,0,13,21,157,1,0,158,157,Kast,
1121,73860006,6M,7,66,20,13,0,8,9,123,1,0,124,123,Kast,
1287,76712002,2,16,52,11,8,2,4,13,106,1,0,107,106,Kast,
1145,73940007,7M,10,85,18,12,2,7,16,150,1,3,154,153,Kast,
1264,75451005,5V,12,89,5,2,3,4,0,115,1,2,118,117,Kast,
1264,75451006,6V,16,95,13,6,0,4,8,142,1,0,143,144,Kast,
1138,73910001,1M,17,30,5,8,2,5,5,72,1,1,74,73,Kast,
1138,73910004,4M,16,60,25,6,1,8,9,125,1,2,128,127,Kast,
1111,73830007,7M,13,46,17,4,0,8,38,126,2,0,128,127,Kast,
1111,73830009,9M,14,40,18,12,0,10,28,122,3,0,125,124,Kast,
1289,76732003,3,18,73,9,8,1,6,12,127,3,1,131,130,Kast,
1133,73900022,22M,18,81,23,20,3,13,13,171,1,2,174,173,Kast,
1136,73900013,13M,17,66,10,10,0,7,7,117,1,0,118,124,Kast,
1131,73880004,4M,12,67,13,13,0,6,1,112,1,0,113,112,Kast,
1131,73880009,9M,6,63,15,13,1,9,5,112,2,0,114,115,Kast,
1131,73880018,18M,9,82,18,18,0,8,11,146,0,1,147,139,Kast,
2615,74301002,2V,27,56,23,12,1,6,18,143,2,1,146,148,Kast,
2631,74371031,31V,27,51,16,13,2,2,27,138,2,0,140,139,Kast,
2634,74370040,40M,21,68,21,25,1,10,23,169,1,10,180,170,Kast,
2636,74371005,5V,18,39,19,21,1,7,15,120,0,1,121,120,Kast,
2646,74401003,3V,14,27,21,16,1,1,11,91,2,0,93,94,Kast,
2642,74391035,35V,28,53,17,10,0,7,19,134,1,2,137,138,Kast,
2642,74391040,40V,28,77,21,13,3,1,19,162,1,162,325,163,Kast,
2652,75600002,2M,26,48,31,16,1,7,15,144,3,3,150,1491,Kast,
2614,74291012,12V,21,55,17,13,1,6,17,130,3,1,134,133,Kast,
2606,74271008,8V,19,33,22,11,2,7,9,103,1,2,106,126,Kast,
2639,74381018,18V,17,57,19,9,0,8,14,124,1,2,127,128,Kast,
2640,74380001,1M,10,49,13,13,2,3,8,98,1,1,100,99,Kast,
2623,74342038,38,22,36,10,11,4,2,23,108,2,1,111,113,Kast,
2603,74252207,207,109,50,11,12,5,6,16,209,1,0,210,209,Boric,
2590,74251083,83V,48,38,29,14,3,11,24,167,0,0,167,168,Boric,
2591,74252190,190,42,25,3,9,4,3,39,125,1,0,126,127,Boric,- Falla VBL
2592,74250065,65M,38,45,23,17,3,12,20,158,3,0,161,342,Kast,
2594,74251088,88V,73,42,19,19,3,6,14,176,2,2,180,181,Boric,
2595,74250013,13M,38,52,26,22,2,7,10,157,1,1,159,158,Kast,
2597,74251044,44V,47,50,22,23,3,5,16,166,1,0,167,165,Kast,
2597,74251046,46V,44,52,23,14,4,8,23,168,1,0,169,172,Kast,
2598,74251159,159V,64,58,19,17,3,5,29,195,2,1,198,199,Boric,
2598,74251162,162V,65,70,14,25,4,13,14,205,2,0,207,205,Kast,
1373,74670006,6M,31,32,15,18,1,7,13,117,2,1,120,121,Kast,
1373,74670011,11M,31,34,23,19,2,6,15,130,3,2,135,136,Kast,
1373,74670012,12M,33,41,19,20,0,7,7,127,0,1,128,127,Kast,
1376,74671024,24V,38,38,19,13,1,6,19,134,0,2,136,142,Boric,
1376,74671026,26V,19,30,20,15,1,3,16,104,2,0,106,107,Kast,
1465,77362006,6,18,33,20,18,1,6,14,110,1,5,116,114,Kast,
1369,74650032,32M,39,41,30,21,3,16,29,179,1,1,181,183,Kast,
1365,74652061,61,45,26,25,14,3,7,20,140,1,0,141,145,Boric,
1366,74651027,27V,36,30,19,13,2,7,27,134,1,0,135,2,Boric,
1366,74651028,28V,40,40,26,8,1,10,24,149,2,2,153,158,Boric,
1384,74721002,2V,23,29,21,5,0,2,7,87,2,0,89,94,Kast,
1382,74710011,11M,19,45,26,19,0,18,25,152,3,1,156,166,Kast,
1383,74711005,5V,24,28,24,16,1,7,13,113,2,1,116,0,Kast,
1383,74711008,8V,30,26,37,17,1,7,19,137,2,2,141,1,Provoste,
1389,74760006,6M,32,32,17,9,1,5,37,133,1,0,134,135,Parisi,
1393,74792035,35,25,22,8,7,1,5,28,96,0,1,97,96,Parisi,
1394,74791019,19V,27,36,27,12,3,7,30,142,1,3,146,145,Kast,
1385,74730003,3M,22,13,25,5,0,1,9,75,0,0,75,76,Provoste,
1348,74580018,18M,31,51,15,16,2,11,22,148,2,2,152,153,Kast,
1417,75731001,1V,4,32,6,4,3,6,6,61,2,8,71,78,Kast,
1363,74642024,24,29,74,10,17,1,4,17,152,1,3,156,155,Kast,
1362,74630019,19M,42,77,32,17,2,8,26,204,1,2,207,206,Kast,
1411,75621002,2V-3V,14,74,25,15,2,4,2,136,1,2,139,149,Kast,
1356,74610010,10M,12,71,15,13,1,6,14,132,1,0,133,132,Kast,
1431,76351001,1V,13,85,20,10,4,3,18,153,0,3,156,158,Kast,
1447,77082168,168,27,45,16,14,1,5,27,135,0,1,136,135,Kast,
1448,77082184,184,30,38,15,14,2,9,21,129,0,0,129,128,Kast,
1448,77082185,185,26,39,15,17,0,10,20,127,1,0,128,130,Kast,
1448,77082194,194,32,40,18,14,2,9,16,131,1,0,132,127,Kast,
1448,77082202,202,31,48,15,15,0,12,25,146,3,0,149,148,Kast,
1455,77082026,26,31,48,12,17,4,7,19,138,0,2,140,139,Kast,
1455,77082027,27,30,55,20,17,0,8,15,145,1,0,146,145,Kast,
1457,77082012,12,26,50,14,18,1,5,23,137,2,0,139,138,Kast,
1457,77082017,17,36,44,13,17,1,6,21,138,0,0,138,139,Kast,
1442,77072092,92,35,47,16,19,13,0,18,148,0,0,148,158,Kast,
1458,77092080,80,62,49,13,32,7,6,18,187,2,0,189,187,Boric,
1458,77092084,84,79,50,18,24,3,8,23,205,7,0,212,206,Boric,
1339,74532057,57,40,96,8,42,0,7,11,204,0,0,204,203,Kast,
1340,74530038,38M,47,107,13,44,0,1,12,224,0,1,225,230,Kast,
1308,74420107,107M,19,44,24,16,0,9,26,138,0,0,138,139,Kast,
1309,74420146,146M,43,54,21,21,1,5,26,171,1,0,172,166,Kast,
1309,74420148,148M,37,58,24,22,1,6,7,155,1,0,156,170,Kast,
1312,74422174,174,45,45,7,9,3,7,35,151,3,0,154,153,Boric,
1316,74421004,4V,18,38,16,19,0,9,6,106,0,0,106,105,Kast,
1316,74421014,14V,20,35,11,11,1,5,12,95,0,0,95,113,Kast,
1316,74421016,16V,20,40,25,16,2,10,12,125,2,0,127,126,Kast,
1317,74420007,7M,15,35,19,17,1,4,14,105,0,1,106,104,Kast,
1319,74421029,29V,23,41,29,21,1,6,9,130,1,1,132,131,Kast,
1320,74420077,77M,26,39,22,17,2,10,27,143,2,0,145,144,Kast,
1321,74421081,81V,34,56,21,15,2,8,14,150,0,0,150,151,Kast,
1403,75430004,4M,26,37,27,10,1,6,20,127,1,1,129,137,Kast,
1403,75430010,10M,39,50,25,11,4,8,31,168,1,0,169,170,Kast,- Falla VBL
1404,75432020,20,32,31,23,15,1,6,43,151,1,1,153,152,Parisi,
1464,77112002,2,38,38,22,9,2,7,34,150,2,0,152,151,Boric,
1432,76752002,2,18,45,21,22,2,8,25,141,2,4,147,146,Kast,
1334,74480001,1M,5,55,14,11,1,1,4,91,1,1,93,96,Kast,
1327,74461011,11V,25,53,28,10,0,5,20,141,1,5,147,148,Kast,
1410,75610002,2M,15,53,30,23,1,2,16,140,0,0,140,141,Kast,
1410,75611003,3V,18,47,37,21,5,5,22,155,2,1,158,153,Kast,
1401,74851003,3V,7,26,15,12,2,5,6,73,0,5,78,76,Kast,
1489,74910018,18M,46,44,21,10,2,11,28,162,21,2,185,165,Boric,
1477,74870028,28M,29,40,23,16,2,11,17,138,2,1,141,142,Kast,
1486,74901001,1V,7,45,10,6,2,1,0,71,2,3,76,75,Kast,
1496,74970006,6M,39,38,24,10,1,4,11,127,8,0,135,129,Boric,
1496,74971006,6V,44,21,22,10,1,8,15,121,3,1,125,124,Boric,
1497,74981001,1V-3V,31,34,19,13,1,3,8,109,1,0,110,111,Kast,
1519,75051221,221V,44,52,25,9,4,8,17,159,1,2,162,152,Kast,
1520,75051154,154V,36,31,13,11,1,9,16,117,1,0,118,117,Boric,
1520,75051157,157V,47,26,9,8,3,9,15,117,2,0,119,118,Boric,
1522,75050127,127M,44,34,13,19,1,22,16,149,2,1,152,151,Boric,
1522,75050131,131M,53,54,15,14,3,15,23,177,0,0,177,180,Kast,
1526,75051048,48V,28,30,11,19,2,3,11,104,2,0,106,116,Kast,
1528,75051192,192V,40,55,10,14,1,10,19,149,1,1,151,152,Kast,
1528,75051200,200V,42,28,6,11,1,5,17,110,0,0,110,109,Boric,
1529,75051236,236V,43,27,13,4,1,7,14,109,0,0,109,110,Boric,- Falla VNU - Falla VBL
1532,75051058,58V,51,32,16,15,1,19,24,158,2,0,160,158,Boric,
1535,75051163,163V,32,30,4,13,2,16,16,113,2,1,116,115,Boric,
1540,75051022,22V,40,44,21,8,0,17,13,143,1,1,145,148,Kast,
1542,75050060,60M,46,40,17,7,1,26,15,152,0,0,152,150,Boric,
1552,75101006,6V-8V,45,27,27,3,1,15,15,133,3,2,138,140,Boric,
